17 40
48 49 54 51 50 52 49 52 55 51 52 53 49 52 51 48 52
54 52 53 62 48 55 48 51 52 55 55 54 52 50 54 53 50
55 48 62 61 62 48 52 49 54 53 54 51 48 55 52 50 54
50 49 51 62 54 53 54 50 49 48 55 50 54 55 49 54 48
54 50 48 48 52 52 62 55 62 62 50 62 49 48 53 52 55
53 54 53 62 55 50 62 62 62 62 62 62 53 62 50 48 53
51 62 48 62 62 62 62 62 62 62 62 62 62 62 62 62 54
62 62 62 62 62 62 62 62 62 62 62 62 62 62 62 62 51
62 62 41 41 62 27 27 62 62 62 27 27 62 41 41 62 62
62 62 41 41 32 41 41 41 41 41 41 41 41 41 41 62 62
62 62 41 41 32 32 41 41 41 41 41 41 41 41 41 62 62
62 62 62 41 41 32 32 32 32 32 32 41 41 41 62 62 62
62 62 62 41 41 41 41 41 41 41 32 32 41 41 62 62 62
62 62 62 41 41 41 41 41 41 41 41 32 41 41 62 62 62
62 62 62 41 41 41 41 41 41 41 41 32 41 41 62 62 62
62 62 62 41 41 41 41 41 41 41 41 32 41 41 62 62 62
62 62 62 41 41 41 41 41 41 41 32 32 41 41 62 62 62
62 62 41 41 41 32 32 32 32 32 32 41 41 41 41 62 62
62 62 41 41 32 32 41 41 41 41 41 41 41 41 41 62 62
62 62 41 41 32 41 41 41 41 41 41 41 41 41 41 62 62
62 62 41 41 32 41 41 41 41 41 41 41 41 41 41 62 62
62 62 41 41 32 32 41 41 41 41 41 41 41 41 41 62 62
62 62 41 41 41 32 32 32 32 32 41 41 41 41 41 62 62
62 62 41 41 41 41 41 41 41 32 32 32 32 41 41 62 62
62 62 41 41 41 41 41 41 41 32 32 32 32 41 41 62 62
62 62 41 41 41 41 41 41 41 32 32 32 32 41 41 62 62
62 62 41 41 41 41 32 32 32 32 32 32 32 41 41 62 62
62 62 41 41 41 32 32 41 41 41 41 41 41 41 41 62 62
62 62 41 41 41 32 41 41 41 41 41 41 41 41 41 62 62
62 41 41 41 41 32 41 41 41 41 41 41 41 41 41 41 62
62 41 41 41 41 32 41 41 41 41 41 41 41 41 41 41 62
62 41 41 41 41 32 32 32 41 41 41 41 41 41 41 41 62
62 41 41 41 41 41 41 32 32 32 32 32 32 41 41 41 62
62 41 41 41 41 41 41 41 41 41 41 41 32 32 41 41 62
62 41 41 41 41 41 41 41 41 41 41 41 41 32 41 41 62
62 41 41 41 32 32 32 32 32 32 32 32 32 32 41 41 62
62 41 41 32 32 32 32 32 32 32 32 32 32 32 41 41 62
62 41 41 32 32 32 32 32 32 32 32 32 32 32 41 41 62
62 41 41 32 32 32 32 32 32 32 32 32 32 41 41 41 62
62 41 41 41 41 41 41 41 41 41 41 41 41 41 41 41 62