20 50
62 62 41 41 41 41 41 41 41 38 38 41 41 41 41 41 41 41 62 62
62 41 41 40 40 40 38 38 38 38 38 38 41 38 40 40 41 41 41 62
41 41 38 38 38 38 38 38 38 38 38 38 41 38 38 38 38 40 41 41
41 38 38 38 38 38 38 38 38 38 38 38 41 38 38 38 38 38 38 41
41 38 38 38 38 38 38 38 41 41 41 41 38 38 38 38 38 38 38 41
41 38 38 38 38 41 38 38 38 38 38 38 38 38 38 38 38 38 38 41
41 38 38 38 38 38 38 38 38 38 38 38 38 38 38 38 38 38 38 41
41 38 38 41 38 38 38 38 38 38 38 38 38 38 38 38 47 38 38 41
41 38 38 38 38 38 38 38 38 38 38 38 38 38 38 38 45 38 38 41
41 38 38 38 38 38 38 38 38 38 38 47 38 38 38 38 45 38 38 41
41 47 38 38 38 38 38 38 38 38 38 45 38 38 38 38 45 38 47 41
41 45 38 38 38 38 47 47 38 38 38 45 38 38 38 38 45 38 45 41
41 45 38 38 38 38 45 45 38 38 38 45 38 38 38 38 45 38 45 41
41 46 38 38 38 38 45 45 38 38 38 45 38 38 38 38 45 47 45 41
41 41 41 38 38 38 45 45 38 38 38 45 38 38 38 38 45 45 45 41
41 41 38 38 38 38 45 45 38 38 38 45 38 38 38 38 46 46 46 41
41 41 38 38 38 38 45 45 38 38 38 46 38 38 38 41 41 41 41 41
41 41 38 38 38 38 46 46 38 38 38 41 38 38 38 38 41 41 41 41
41 40 38 38 38 38 41 41 38 38 38 38 38 38 38 38 38 38 38 41
41 38 38 38 38 38 38 38 38 38 38 38 38 38 38 38 38 38 38 41
41 38 38 41 38 38 38 38 38 38 38 38 38 38 38 38 38 38 38 41
41 38 38 38 38 38 38 38 38 38 38 38 38 38 38 38 38 38 38 41
41 38 38 38 38 38 38 38 38 38 38 38 38 38 38 38 38 38 38 41
41 41 38 38 38 38 38 38 38 38 38 38 38 38 38 38 38 38 38 41
41 41 38 38 38 38 38 38 38 38 38 38 38 38 38 38 38 38 38 41
41 41 38 38 38 38 38 38 38 38 38 38 38 38 38 38 38 38 38 41
41 41 47 38 38 38 47 38 38 38 47 38 38 38 47 38 38 38 38 41
41 41 45 38 38 38 45 38 38 38 45 38 38 38 45 38 38 38 38 41
41 41 46 38 38 38 45 38 38 38 45 38 38 38 45 38 38 47 38 41
41 41 41 38 38 38 45 38 38 38 45 38 38 38 45 38 38 45 38 41
41 41 38 38 38 38 45 38 38 38 45 38 38 38 45 38 38 45 38 41
41 38 38 38 38 38 45 38 38 38 45 38 38 38 45 38 38 45 47 41
41 38 38 38 38 38 45 38 38 38 45 38 38 38 45 38 38 45 45 41
41 38 38 38 38 38 45 38 38 38 45 38 38 38 45 38 38 45 45 41
41 38 38 38 38 38 45 38 38 38 45 38 38 38 45 38 38 46 46 41
41 38 38 38 38 38 45 38 38 38 45 38 38 38 45 38 38 41 41 41
41 38 38 38 38 38 45 38 38 38 45 38 38 38 45 38 38 38 41 41
41 38 38 38 38 38 45 38 38 38 45 38 38 38 45 38 38 38 38 41
41 47 38 38 38 38 45 38 38 38 45 38 38 38 45 38 38 38 38 41
41 45 38 38 38 38 45 38 38 38 45 38 38 38 45 38 38 38 38 41
41 45 38 38 38 38 45 38 38 38 45 38 38 38 45 38 38 38 38 41
41 46 38 38 38 38 45 38 38 38 45 38 38 38 45 38 38 38 38 41
41 41 38 38 38 38 46 38 38 38 46 38 38 38 46 38 38 38 38 41
41 41 41 39 39 39 41 39 39 39 41 39 39 39 41 38 38 38 38 41
41 41 41 41 41 41 41 41 41 41 41 41 41 41 41 41 38 38 38 41
38 38 38 47 38 38 38 38 38 47 38 38 38 38 38 47 38 38 38 41
38 38 38 45 38 38 38 38 38 45 38 38 38 38 38 45 38 38 38 41
38 38 38 45 38 38 38 38 38 45 38 38 38 38 38 45 38 38 41 41
38 38 38 46 38 38 38 38 38 46 38 38 38 38 38 46 38 41 41 41
41 41 41 41 41 41 41 41 41 41 41 41 41 41 41 41 41 41 41 41