40 40
1 1 1 1 3 1 1 1 1 1 7 7 7 1 1 1 1 1 1 1 1 1 1 1 1 1 1 1 1 7 7 1 1 1 1 1 1 1 1 1
1 1 1 1 1 1 1 1 1 1 7 7 7 1 1 1 1 1 1 1 1 1 1 1 1 1 1 1 1 7 7 1 1 1 1 1 3 1 1 1
1 1 1 1 1 1 1 1 1 1 7 7 7 1 1 1 1 1 1 1 1 1 1 1 1 1 1 1 1 7 7 1 1 1 1 1 1 1 1 1
1 1 1 1 1 1 1 1 1 1 7 7 7 1 1 1 1 1 1 1 1 1 1 1 1 1 1 1 1 7 7 1 1 1 1 1 1 1 1 1
1 9 1 1 1 1 1 1 1 1 7 7 7 1 1 1 1 1 1 1 1 1 1 1 1 1 1 1 10 7 7 1 1 1 1 1 9 1 1 1
0 0 0 0 14 14 14 14 14 0 0 0 0 0 14 14 14 14 14 14 14 14 14 14 14 14 14 14 0 0 0 0 14 14 14 14 0 0 0 0
0 2 2 2 15 15 15 15 15 2 0 0 0 2 15 15 15 15 15 15 15 15 15 15 15 15 15 15 2 2 2 2 15 15 15 15 2 2 0 0
2 2 2 15 15 15 15 15 15 2 2 2 2 2 15 15 15 15 15 15 17 2 2 2 15 15 15 15 16 2 2 16 15 15 15 15 15 2 2 2
16 16 15 15 15 15 15 15 15 16 2 2 2 16 15 15 15 15 15 15 2 2 2 16 16 15 15 15 16 16 16 16 15 15 15 15 15 15 16 16
16 15 15 15 15 15 15 15 15 16 16 16 16 16 15 15 15 15 15 15 16 2 16 16 16 15 15 15 16 16 16 16 15 15 15 15 15 15 15 16
16 15 15 15 15 15 15 15 16 16 16 16 16 16 15 15 15 15 15 15 16 16 16 16 16 15 15 16 16 16 16 16 16 15 15 15 15 15 15 16
16 15 15 15 15 15 15 15 16 16 16 16 16 15 15 15 15 15 15 15 16 16 16 16 16 16 15 16 16 16 16 16 16 15 15 15 15 15 15 16
15 15 15 15 15 15 15 15 16 16 16 16 16 15 15 15 15 15 15 15 16 16 16 16 16 16 15 15 16 16 16 16 16 15 15 15 15 15 15 16
15 15 15 15 15 15 15 15 16 16 16 16 16 15 15 15 15 15 15 15 16 16 16 16 16 16 15 15 16 16 16 16 16 15 15 15 15 15 15 16
15 15 15 15 15 15 15 16 16 16 16 16 16 16 15 15 15 15 15 15 16 16 16 16 16 16 15 15 15 15 16 16 16 16 15 15 15 15 15 16
15 15 15 15 15 15 15 16 16 16 16 16 16 16 15 15 15 15 15 15 16 16 16 16 16 16 16 16 16 15 15 16 16 16 15 15 15 15 15 16
15 15 15 15 15 15 15 16 16 16 16 16 16 16 15 15 15 15 15 15 15 16 16 16 16 16 15 15 15 15 15 16 16 16 15 15 15 15 15 16
15 15 15 15 15 15 15 16 16 16 16 16 16 16 16 15 15 15 15 15 15 15 16 16 16 15 15 15 15 15 15 16 16 16 15 15 15 15 15 16
15 15 15 15 15 15 16 16 16 16 16 16 16 16 16 16 15 15 15 15 15 15 16 16 16 15 15 15 15 15 15 16 16 16 15 15 15 15 15 16
15 15 15 15 15 15 16 16 16 16 16 16 16 16 16 16 15 15 15 15 15 15 16 16 16 15 15 15 15 16 16 16 16 15 15 15 15 15 15 16
15 15 15 15 15 15 16 16 16 16 16 16 16 16 16 16 15 15 15 15 15 15 16 16 16 15 15 16 16 16 16 16 16 15 15 15 15 15 15 16
15 15 15 15 15 15 16 16 16 2 2 2 2 2 16 16 16 15 15 15 15 15 15 16 16 15 15 16 16 16 16 16 16 15 15 15 15 15 16 16
15 15 15 15 15 16 16 16 16 15 15 15 15 15 15 16 16 16 15 15 15 15 15 16 16 15 15 16 16 16 16 16 16 15 15 15 15 15 16 16
15 15 15 15 15 16 16 15 15 15 15 15 15 15 15 15 16 16 15 15 15 15 15 16 16 15 15 16 16 16 16 16 16 15 15 15 15 15 16 16
15 15 15 15 15 16 15 15 15 15 15 15 15 15 15 15 15 15 15 15 15 15 15 16 16 15 15 16 16 16 16 16 16 15 15 15 15 15 16 16
15 15 15 15 15 15 15 15 15 15 15 15 15 15 15 15 15 15 15 15 15 15 15 16 16 15 15 16 16 16 16 16 16 15 15 15 15 15 16 16
15 15 15 15 15 15 15 15 15 15 15 15 15 15 15 15 15 15 15 15 15 15 15 2 16 15 15 16 16 16 16 16 16 15 15 15 15 15 16 16
15 15 15 15 15 15 15 15 15 17 15 15 15 15 15 15 15 15 15 15 15 15 15 2 16 15 15 16 16 16 16 16 15 15 15 15 15 15 16 16
15 15 15 15 15 15 15 15 15 2 2 2 2 15 17 15 15 15 15 15 15 15 15 2 16 15 15 16 16 16 16 16 15 15 15 15 15 15 16 16
15 15 15 15 15 2 2 2 2 2 2 2 2 2 2 2 2 15 15 15 17 17 2 2 16 15 15 16 16 16 16 16 15 15 15 15 15 15 16 16
17 15 15 15 2 2 2 2 16 16 16 16 16 16 16 2 2 2 2 2 2 2 2 16 16 15 15 16 16 16 16 15 15 15 15 15 15 15 16 16
2 2 2 2 2 2 2 16 16 16 16 16 16 16 16 16 16 16 2 2 2 2 16 16 16 15 15 16 16 16 16 15 15 15 15 15 15 15 16 16
2 2 2 2 2 16 16 16 16 16 16 16 16 16 16 16 16 16 16 16 16 16 16 16 15 15 15 16 16 16 16 15 15 15 15 15 15 16 16 16
16 16 16 16 16 16 16 16 16 16 16 16 16 16 16 16 16 16 16 16 16 15 15 15 15 15 15 16 16 16 16 15 15 15 15 15 15 16 16 16
16 16 16 16 16 16 16 16 16 16 16 16 16 16 16 16 16 16 16 16 15 15 15 15 15 15 15 16 16 16 16 16 15 15 15 15 15 16 16 16
16 16 16 16 16 16 16 16 16 16 16 16 16 16 16 16 16 16 16 16 15 15 15 15 15 15 16 16 16 16 16 16 15 15 15 15 15 16 16 16
16 16 16 16 16 16 16 16 16 16 16 16 16 16 16 16 16 16 16 15 15 15 15 15 15 16 16 16 16 16 16 16 15 15 15 15 15 2 16 16
16 16 16 16 16 16 16 16 16 16 16 16 16 16 16 16 16 16 16 15 16 16 16 16 16 16 16 16 16 16 15 15 15 15 15 17 2 2 16 16
16 16 16 16 16 16 16 16 16 16 16 16 16 16 16 16 16 16 16 15 15 15 15 15 15 15 15 15 15 15 15 16 2 17 15 2 2 2 16 16
16 16 16 16 16 16 16 16 16 16 16 16 16 16 16 16 16 16 16 16 16 16 16 16 16 16 16 16 16 16 16 16 16 2 2 2 2 16 16 16