50 40
16 16 16 16 16 16 16 16 16 16 16 16 16 16 16 16 32 32 32 32 32 32 32 32 16 16 16 16 16 16 16 16 32 32 32 32 32 32 32 37 37 37 37 37 37 37 37 37 37 37
16 16 16 16 16 16 16 16 16 16 16 16 16 16 16 32 32 32 32 32 32 32 32 32 16 16 16 16 16 16 16 16 32 32 32 32 32 32 32 37 37 32 32 44 32 32 32 44 32 32
16 16 16 16 16 16 16 16 16 16 16 16 16 32 32 32 32 32 32 32 32 32 32 32 16 16 16 16 16 16 16 16 32 32 32 32 32 32 32 32 37 32 32 42 32 32 32 42 32 32
16 16 16 16 16 16 16 32 32 32 32 32 32 32 32 32 32 32 32 32 32 32 32 16 16 16 16 16 16 16 16 16 32 32 32 32 32 32 32 32 37 32 32 42 32 32 32 42 32 32
16 16 16 16 16 32 32 32 32 32 32 32 32 32 32 32 32 32 32 32 32 32 32 16 16 16 16 16 16 16 16 16 16 32 32 32 32 32 32 32 32 32 32 42 32 32 32 42 32 32
16 16 16 16 16 32 32 32 32 32 32 32 32 32 32 32 32 32 32 32 32 32 32 16 16 16 16 16 16 16 16 16 32 32 32 32 32 32 32 32 32 32 32 42 32 32 32 42 32 32
16 16 16 32 32 32 32 32 32 32 32 32 32 32 32 32 32 32 32 32 32 32 32 16 16 16 16 16 16 16 16 16 32 32 32 32 32 37 37 37 37 32 32 42 32 32 32 42 32 32
16 32 32 32 32 32 32 32 32 32 32 32 32 32 32 32 32 32 32 32 32 32 32 16 16 16 16 16 16 16 16 16 32 32 32 32 32 32 32 37 37 32 32 43 32 32 32 43 32 32
16 32 32 32 32 32 32 32 32 32 32 32 32 32 32 32 32 32 32 32 32 32 32 16 16 16 16 16 16 16 16 16 16 32 32 32 32 32 32 32 37 37 37 37 37 37 37 37 37 37
16 32 32 32 32 32 32 32 32 32 32 32 32 32 32 32 32 32 32 32 32 32 16 16 16 16 16 16 16 16 16 16 32 32 32 32 32 32 32 32 37 37 37 37 37 37 37 37 37 37
16 32 32 32 32 32 16 16 16 16 16 16 16 16 16 16 16 16 16 16 16 16 16 16 16 16 16 16 16 16 16 16 32 32 32 32 32 32 32 32 37 37 37 37 37 37 37 37 37 37
16 32 32 32 32 16 16 16 16 16 16 16 16 16 16 16 16 16 16 16 16 16 16 16 16 16 16 16 16 16 16 16 32 32 32 32 32 32 32 32 32 32 32 32 32 32 32 32 32 32
16 32 32 32 32 16 16 16 16 16 16 16 16 16 16 16 16 16 16 16 16 16 16 16 16 16 16 16 16 16 16 16 16 32 32 32 32 32 32 32 32 37 32 32 32 32 32 32 32 32
16 32 32 32 32 32 16 16 16 16 16 16 16 16 16 16 16 16 16 16 16 16 16 16 16 16 16 16 16 16 16 16 32 32 32 32 32 32 32 32 32 37 32 32 32 32 32 32 32 32
16 32 32 32 32 32 32 32 16 16 16 16 16 16 16 16 16 16 16 16 16 16 16 16 16 16 16 16 16 16 16 16 32 32 32 32 32 32 32 32 32 37 32 32 32 32 32 32 32 32
16 32 32 32 32 32 32 32 32 32 32 32 32 16 16 16 16 16 16 16 16 16 16 16 16 16 16 16 16 16 16 16 32 32 32 32 32 32 32 32 32 37 37 32 32 32 32 32 32 32
16 16 32 32 32 32 32 32 32 32 32 32 32 32 36 36 36 32 16 16 16 16 16 16 16 16 16 16 16 16 16 16 16 32 32 32 32 32 32 32 32 37 32 32 32 32 37 32 32 32
16 16 32 32 32 32 32 32 32 32 32 32 32 32 32 32 32 32 32 32 32 32 32 32 32 16 16 16 16 16 16 16 16 35 32 32 32 32 32 32 32 37 32 32 32 32 32 32 32 32
16 16 16 32 32 32 32 32 32 32 32 32 32 32 32 32 32 32 32 32 32 32 32 32 32 32 16 16 16 16 16 16 16 16 32 32 32 32 32 32 32 37 32 32 32 32 32 32 32 32
16 16 16 16 32 32 32 32 32 32 32 32 32 32 32 32 32 32 32 32 32 32 32 32 32 32 32 32 32 16 16 16 16 16 16 16 32 32 32 32 32 37 32 32 32 32 32 32 32 32
16 16 16 16 16 33 33 33 16 16 16 16 32 32 32 32 32 32 32 32 32 32 32 32 32 32 32 32 32 32 16 16 16 16 16 16 16 16 32 32 16 37 32 32 32 32 32 37 32 32
16 16 16 16 34 34 34 34 34 16 16 16 16 16 16 16 16 16 32 32 32 32 32 32 32 32 32 32 32 32 16 16 16 16 16 16 16 16 16 16 16 32 32 32 32 32 32 32 32 32
16 16 16 16 16 34 34 34 16 16 16 16 16 16 16 16 16 16 16 32 32 32 32 32 32 32 32 32 32 32 32 16 16 16 16 16 16 16 16 16 16 32 32 32 32 32 32 32 32 32
16 16 16 16 16 16 16 16 16 16 16 16 16 16 16 16 16 16 16 32 32 32 32 32 32 32 32 32 32 32 32 32 16 16 16 16 16 16 16 16 16 37 37 37 32 37 32 32 32 32
16 16 16 16 16 16 16 16 16 16 16 16 16 16 16 16 16 16 16 16 16 32 32 32 32 32 32 32 32 32 32 32 16 16 16 16 16 16 16 16 16 37 37 32 32 32 32 32 37 32
16 16 16 16 16 16 16 16 16 16 16 16 16 16 16 16 16 16 16 16 16 35 16 32 32 32 32 32 32 32 32 32 32 32 32 32 32 16 16 16 32 37 37 32 32 32 32 32 32 32
16 16 16 16 16 16 16 16 16 16 16 16 16 16 16 16 16 16 16 16 16 16 16 16 32 32 32 32 32 32 32 32 32 32 32 32 32 32 32 32 32 32 37 32 32 32 32 32 32 32
16 16 16 16 16 16 16 16 16 16 16 16 16 16 16 16 16 16 16 16 16 16 16 16 16 32 32 32 32 32 32 32 32 32 32 32 32 32 32 32 32 32 37 32 32 32 32 32 32 32
16 16 16 16 16 16 16 16 16 16 16 16 16 16 16 16 16 16 16 16 16 16 16 16 16 32 32 32 32 32 32 32 32 32 32 32 32 32 32 32 32 32 37 32 32 32 32 37 32 32
16 16 16 16 16 16 16 16 16 16 16 16 16 16 16 16 16 16 16 16 16 16 16 16 16 16 32 32 32 32 32 32 32 32 32 32 32 32 32 32 32 32 37 32 37 32 32 32 32 32
16 16 16 16 16 16 16 16 16 16 16 16 16 16 16 16 16 16 16 16 16 16 16 16 16 16 32 32 32 32 32 32 32 32 32 32 32 32 32 32 32 32 37 32 32 32 32 32 32 32
16 16 16 16 16 16 16 16 16 16 16 16 16 16 16 16 16 16 16 16 16 16 16 16 16 16 16 32 32 32 32 32 32 32 32 32 32 32 32 32 32 32 32 32 32 32 32 32 32 32
16 16 16 16 16 16 16 16 16 16 16 16 16 16 16 16 16 16 16 16 16 16 16 16 16 16 16 16 32 32 32 32 32 32 32 32 32 32 32 32 32 32 32 32 32 32 32 32 32 32
16 16 16 16 16 16 16 16 16 16 16 16 16 16 16 16 16 16 16 16 16 16 16 16 16 16 16 16 16 33 33 33 16 16 33 33 33 16 33 33 37 37 37 37 37 37 37 37 37 37
16 16 16 16 16 16 16 16 16 16 16 16 16 16 16 16 16 16 16 16 16 16 16 16 16 16 16 16 34 34 34 34 16 34 34 34 34 34 34 34 37 37 37 37 37 37 37 37 37 37
16 16 16 16 16 16 16 16 16 16 16 16 16 16 16 16 16 16 16 16 16 16 16 16 16 16 16 16 34 34 34 34 34 34 34 34 34 34 34 34 37 37 37 37 37 37 37 37 37 37
16 16 16 16 16 16 16 16 16 16 16 16 16 16 16 16 16 16 16 16 16 16 16 16 16 16 16 34 34 34 34 34 34 34 34 34 34 34 34 34 16 16 16 16 16 16 16 16 16 16
16 16 16 16 16 16 16 16 16 16 16 16 16 16 16 16 16 16 16 16 16 16 16 16 16 16 16 34 34 34 34 34 34 34 34 34 34 34 34 34 16 16 16 16 16 16 16 16 16 16
16 16 16 16 16 16 16 16 16 16 16 16 16 16 16 16 16 16 16 16 16 16 16 16 16 16 16 34 34 34 34 34 34 34 34 34 34 34 34 34 16 16 16 16 16 16 16 16 16 16
16 16 16 16 16 16 16 16 16 16 16 16 16 16 16 16 16 16 16 16 16 16 16 16 16 16 34 34 34 34 34 34 34 34 34 34 34 34 34 34 34 16 16 16 16 16 16 16 16 16
16 16 16 16 16 16 16 16 16 16 16 16 16 16 16 16 16 16 16 16 16 16 16 16 16 16 34 34 34 34 34 34 34 34 34 34 34 34 34 34 34 16 16 16 16 16 16 16 16 16