34 25
3 1 1 1 1 1 1 1 1 1 1 1 1 1 1 1 1 1 1 1 1 1 1 1 1 1 1 1 1 1 1 1 1 1
1 1 1 1 1 1 1 1 1 1 1 1 1 1 1 1 1 1 1 1 1 1 1 1 1 1 1 1 1 1 1 1 1 1
1 1 1 1 1 1 1 1 1 1 1 1 1 1 1 1 1 1 1 1 1 1 1 1 1 1 1 1 1 1 1 1 1 1
1 1 2 2 2 2 2 2 2 2 2 1 1 1 1 1 1 1 1 1 1 1 1 1 1 1 1 1 1 1 1 1 1 1
1 1 1 1 1 1 1 1 1 1 1 1 2 2 2 2 1 1 1 1 1 1 1 1 1 1 1 1 1 1 1 1 1 1
1 1 1 1 1 1 1 1 1 1 1 1 1 1 1 1 1 1 1 1 1 1 1 1 1 1 1 1 1 1 1 1 1 1
1 1 1 1 1 1 1 1 1 1 1 1 1 1 1 1 1 1 2 2 2 28 28 2 2 2 2 1 1 1 1 1 1 1
1 1 1 1 1 1 1 1 1 1 1 1 1 1 1 1 1 1 1 1 1 1 1 1 1 1 1 1 1 1 2 1 1 1
1 1 1 1 1 1 1 1 1 1 1 1 1 1 1 1 1 1 1 1 1 1 1 1 1 1 1 1 1 1 1 1 1 1
1 1 1 1 1 1 1 1 1 1 1 1 1 1 1 1 1 1 1 1 1 1 1 1 1 1 1 1 1 1 1 1 1 1
1 1 1 1 1 1 1 1 1 1 1 1 1 1 1 1 1 1 1 1 1 1 1 1 1 1 1 1 1 1 1 1 1 2
1 1 1 1 1 1 1 1 1 1 1 1 1 1 1 1 1 1 1 1 1 1 1 1 1 1 1 1 1 1 1 1 1 1
1 1 1 1 1 1 12 1 1 1 1 1 1 2 33 35 35 1 1 1 1 1 1 1 1 1 1 1 1 1 1 1 1 1
1 1 1 1 1 1 13 1 1 1 1 1 2 2 2 2 2 2 32 2 33 33 33 33 33 33 33 33 33 2 32 32 32 2
1 1 1 1 1 1 7 1 1 1 1 2 2 27 27 27 27 27 32 2 16 16 16 16 16 16 34 34 34 2 2 32 32 2
2 2 2 2 2 2 2 2 33 33 33 2 27 27 27 27 27 27 27 2 16 16 16 16 16 16 34 34 34 16 32 32 32 2
2 2 2 2 2 2 2 2 2 2 2 2 27 27 27 27 27 27 27 2 16 16 16 16 16 16 16 16 16 16 27 27 2 2
2 27 27 27 27 27 27 27 27 27 27 27 27 27 27 27 27 27 27 16 27 27 27 27 27 27 27 27 27 27 27 16 16 2
2 27 27 27 27 27 27 27 27 27 27 27 27 27 27 28 28 27 27 16 27 27 27 27 16 27 27 27 27 27 16 16 16 2
2 27 27 16 16 16 16 16 16 16 16 16 16 16 16 16 16 16 16 16 27 27 27 27 27 27 27 27 27 16 16 16 16 2
2 27 27 27 27 27 27 27 27 27 27 27 27 27 27 27 27 27 27 27 27 27 27 27 27 27 27 27 16 16 16 16 16 2
2 27 27 16 16 16 16 16 16 16 16 16 27 27 27 27 27 27 27 27 27 27 27 27 16 16 35 16 16 16 16 16 16 2
2 27 27 27 27 27 27 27 27 27 27 27 16 27 27 27 27 27 27 27 27 27 27 27 27 27 27 27 27 27 27 27 27 2
2 27 27 27 27 27 27 27 27 27 27 27 27 16 27 27 27 27 27 27 27 27 27 27 27 27 27 27 27 27 27 27 27 2
2 2 2 2 2 2 2 2 2 2 2 2 2 2 2 28 28 2 28 28 2 28 2 2 2 2 2 2 33 33 33 33 33 2