34 20
16 16 16 16 16 16 16 16 16 16 16 37 16 16 16 16 16 16 16 16 16 16 16 16 16 16 16 16 16 16 16 16 16 16
16 16 16 16 16 16 16 16 16 37 37 32 32 32 32 32 32 32 32 32 32 32 32 32 32 32 32 32 32 32 32 32 16 16
16 16 32 32 32 32 16 16 16 16 16 32 32 32 32 16 16 16 16 16 16 16 16 16 16 16 16 16 16 32 32 32 32 37
16 32 32 32 16 32 32 32 32 32 16 32 32 32 32 16 16 16 16 16 16 16 16 16 16 16 16 16 16 16 16 32 32 37
16 32 32 16 16 32 32 16 32 32 16 32 32 16 16 16 16 16 16 16 16 32 32 32 32 32 32 32 32 32 32 32 32 37
16 32 32 16 16 16 32 16 32 32 16 32 32 16 16 16 16 16 16 16 16 32 32 16 16 16 16 16 16 16 16 32 32 37
16 32 32 16 16 16 32 16 16 16 16 16 16 16 32 32 32 32 32 32 32 32 32 42 42 42 42 42 42 42 42 16 32 37
16 32 32 16 32 32 32 32 32 32 32 32 32 32 32 16 16 16 16 16 16 16 35 42 42 42 42 42 42 42 42 16 16 16
16 32 32 32 32 16 16 16 16 16 16 16 16 16 16 16 32 32 32 32 32 32 32 42 42 42 42 42 42 42 42 16 16 16
16 32 32 32 16 16 16 16 16 16 16 16 16 16 16 16 32 32 32 32 32 32 32 42 42 42 42 42 42 42 42 16 16 16
16 16 32 32 16 16 16 16 16 16 16 16 16 16 16 32 32 32 32 32 32 32 32 42 42 42 42 42 42 42 42 16 16 16
16 16 16 32 16 16 16 16 32 32 32 32 32 32 32 32 32 16 16 35 35 35 16 16 16 16 16 16 33 33 33 16 16 16
16 16 16 32 32 32 32 32 32 32 32 32 32 32 32 32 32 16 16 16 16 16 16 16 16 16 16 16 16 16 16 16 16 16
16 32 32 32 32 32 32 32 16 16 16 16 16 16 16 16 16 16 16 16 16 16 16 16 16 16 16 16 16 16 16 16 16 16
16 32 32 32 16 16 16 16 16 16 16 16 16 16 16 16 16 16 16 16 16 16 16 16 16 16 16 16 16 16 16 16 16 16
16 30 30 16 16 16 16 16 16 16 31 31 31 31 31 31 31 31 31 31 31 31 31 31 31 31 16 16 16 16 16 16 16 16
16 31 31 16 16 16 16 16 31 31 31 31 31 31 31 31 31 31 31 31 31 31 31 31 31 31 16 16 16 16 16 16 16 16
16 31 31 31 31 31 31 31 31 31 31 16 16 16 16 16 16 16 16 16 16 16 31 31 31 31 16 16 16 16 16 16 16 16
16 31 31 31 31 31 31 31 31 31 16 16 16 16 16 16 16 16 16 16 16 16 16 16 31 31 16 16 16 16 16 16 16 16
16 16 16 16 16 16 16 16 16 16 16 16 16 16 16 16 16 16 16 16 16 16 16 16 35 35 16 16 16 16 16 16 16 16