34 17
15 15 16 16 16 16 16 16 16 16 16 16 16 16 16 16 16 16 16 16 16 16 16 16 16 16 15 15 15 15 15 15 15 15
15 15 15 15 15 15 15 15 15 15 15 15 15 15 15 15 15 15 15 15 15 15 32 32 32 16 15 15 15 15 15 15 15 15
15 15 15 17 17 17 17 15 15 15 15 15 17 17 17 17 15 15 15 15 15 15 32 32 32 16 15 15 15 15 15 15 15 15
15 15 16 16 16 16 16 16 16 16 16 16 16 16 16 16 16 16 16 15 15 15 32 32 32 16 15 15 15 15 15 15 15 15
15 15 15 15 15 15 15 15 15 15 15 15 15 15 15 15 15 15 16 16 16 17 32 32 32 16 15 15 15 15 15 15 15 15
15 15 17 17 17 15 15 15 15 15 15 15 15 15 15 15 15 16 16 15 16 16 32 32 32 16 15 15 15 15 15 15 15 15
15 15 16 16 16 16 16 15 15 15 15 15 15 15 15 15 15 15 15 15 15 16 16 32 32 16 15 15 15 15 16 16 16 16
15 15 16 16 16 16 16 16 16 16 16 17 17 15 15 15 15 15 15 15 15 17 16 32 32 16 15 15 15 15 16 32 32 32
15 15 16 16 16 16 16 32 32 32 16 16 16 16 15 16 16 15 15 15 15 16 16 32 32 16 16 16 16 15 16 32 32 32
15 15 16 16 16 16 16 32 32 32 32 32 32 16 16 15 15 15 15 15 15 16 16 32 32 32 32 32 16 16 16 32 32 32
15 15 16 16 16 16 16 32 32 32 32 32 32 32 16 17 17 17 15 15 15 15 16 32 32 32 32 32 32 32 32 32 32 32
15 15 16 16 16 16 16 32 32 32 32 32 32 32 16 16 16 16 15 15 15 15 16 16 16 16 16 32 32 32 32 32 32 32
15 15 15 15 32 32 32 32 32 32 32 32 32 32 32 16 15 15 15 15 15 15 15 15 15 15 16 16 16 16 16 16 16 16
15 15 15 15 32 32 32 32 32 32 32 32 32 32 32 16 15 15 15 15 15 15 15 15 15 15 15 15 15 15 15 15 15 15
15 17 16 16 16 16 16 32 32 32 32 32 32 32 32 16 15 15 15 15 15 15 15 17 17 17 17 17 15 15 15 15 15 15
16 16 16 16 16 16 16 16 16 16 16 16 16 16 16 16 16 16 16 16 16 16 16 16 16 16 16 16 16 16 16 16 16 16
2 2 2 2 2 2 2 2 2 2 2 2 2 2 2 2 2 2 2 2 2 2 2 2 2 2 2 2 2 2 2 2 2 2