50 30
1 1 7 7 7 7 7 7 7 7 7 1 1 1 1 1 1 1 1 1 1 1 1 1 1 1 1 1 1 1 1 1 1 1 1 1 1 1 1 1 1 1 1 1 1 1 1 1 1 1
1 1 7 7 7 7 7 7 7 7 7 1 1 1 1 1 1 1 1 1 1 1 1 1 1 1 1 1 1 1 1 1 1 1 1 1 1 1 1 1 1 1 1 1 1 1 1 1 1 1
1 1 7 7 7 7 7 27 27 27 27 1 1 1 1 1 1 1 1 1 1 1 1 1 1 1 1 1 1 1 1 1 1 1 1 1 1 1 1 1 1 1 1 1 1 1 1 1 1 1
1 1 7 7 7 7 7 27 27 27 27 1 1 1 1 1 1 1 1 1 1 1 1 1 1 1 1 1 1 1 1 1 1 1 1 1 1 1 1 1 1 1 1 1 1 1 1 1 1 1
1 1 7 27 27 27 27 27 27 7 7 7 7 7 27 7 27 1 1 1 1 1 1 1 1 1 1 1 1 1 1 1 1 1 1 1 1 1 1 1 1 1 1 1 1 1 1 1 1 1
1 1 7 27 27 27 27 27 27 7 7 7 7 7 27 27 27 1 1 1 1 1 1 1 1 1 1 1 1 1 1 1 1 1 1 1 1 1 1 1 1 1 1 1 1 1 1 1 1 1
1 3 7 27 27 7 7 7 7 7 7 1 1 7 27 27 27 1 1 1 1 1 27 27 27 27 1 1 1 1 1 1 1 1 1 1 1 1 1 1 1 1 1 1 1 1 1 1 1 1
1 1 7 27 27 27 27 27 27 7 7 1 1 7 7 27 27 1 1 1 1 1 27 27 27 27 1 1 1 1 1 1 1 1 1 1 1 1 1 1 1 1 1 1 1 1 1 1 1 1
1 1 7 27 27 27 27 27 27 7 7 1 1 7 27 27 27 1 1 1 1 1 7 7 7 7 1 1 1 7 7 7 7 7 7 1 7 7 7 7 7 7 7 7 7 7 1 1 1 1
1 1 7 7 7 4 7 27 27 7 7 1 1 7 27 27 27 1 1 1 1 1 7 7 7 7 1 1 1 1 44 1 1 1 1 1 1 1 7 1 1 1 1 1 1 1 7 1 44 1
1 1 7 7 7 7 7 27 27 7 7 1 1 7 27 7 27 1 1 1 5 11 7 7 7 44 1 1 1 1 42 1 1 1 1 1 1 1 7 1 1 1 1 1 1 1 7 1 42 1
1 1 7 7 7 7 27 27 27 27 7 1 1 7 27 27 27 1 1 1 1 1 7 7 1 42 1 1 1 1 42 1 1 1 1 1 1 1 7 1 1 1 1 1 1 1 4 1 42 1
1 1 27 27 27 27 27 27 27 27 7 1 1 7 27 27 27 1 1 1 1 1 7 7 1 42 1 1 1 1 42 1 1 1 1 1 1 1 7 1 1 1 1 1 1 1 7 1 42 1
1 1 27 27 27 27 7 7 7 7 7 1 1 7 7 7 7 1 1 1 1 1 7 7 1 43 1 1 1 1 43 1 1 1 1 1 1 1 7 1 1 1 1 1 1 1 7 1 43 1
1 1 7 7 7 7 7 7 7 7 7 0 0 0 0 0 0 0 0 0 0 0 0 0 0 16 33 33 33 33 16 33 33 33 33 33 33 33 16 0 0 0 0 0 0 18 0 32 0 0
0 0 0 0 0 0 0 0 0 0 0 0 18 18 18 18 18 18 18 18 0 0 0 0 0 16 16 16 16 16 16 16 16 16 16 16 16 16 18 18 18 18 18 18 18 18 0 32 0 0
2 2 18 18 18 18 18 18 18 18 18 18 18 0 0 0 0 0 0 18 18 18 18 18 18 18 18 18 18 18 18 18 18 18 18 18 18 18 18 2 2 2 2 2 2 2 2 32 2 2
1 1 18 18 18 18 18 18 18 18 18 0 0 0 0 0 0 0 0 0 0 0 0 0 0 16 16 16 16 16 16 16 16 16 16 16 16 16 16 0 0 0 0 0 0 0 0 32 0 1
1 5 27 7 7 7 7 7 7 7 7 1 1 7 7 7 7 0 0 0 0 0 0 0 0 16 34 34 34 34 16 34 34 34 34 34 34 34 16 0 0 0 0 0 0 0 0 32 0 1
1 1 27 27 27 27 27 27 27 27 27 1 1 27 27 27 27 1 1 1 1 1 7 7 1 44 1 1 1 1 44 1 1 1 1 1 1 1 1 1 1 1 1 1 1 1 7 1 44 1
6 1 27 27 27 27 27 27 27 27 27 1 1 27 27 27 27 1 1 1 1 1 7 7 1 42 1 1 1 1 42 1 1 1 1 1 1 1 1 1 1 1 1 1 1 1 7 1 42 1
1 1 7 7 7 7 27 27 27 27 7 7 7 7 27 7 27 1 1 1 1 1 7 7 1 42 1 1 1 1 42 1 1 1 1 1 1 1 1 1 1 1 1 1 1 1 4 1 42 1
1 1 7 7 7 7 7 7 27 7 7 7 7 7 27 27 27 1 1 1 5 11 7 7 7 43 1 1 1 1 42 1 1 1 1 1 1 1 1 1 1 1 1 1 1 1 7 1 42 1
1 1 7 7 7 4 7 33 33 7 7 7 7 7 27 27 27 1 1 1 1 1 7 7 7 7 1 1 1 1 43 1 1 1 1 1 1 1 1 1 1 1 1 1 1 1 7 1 43 1
1 1 7 34 34 34 34 34 34 7 7 7 7 7 7 27 27 1 1 1 1 1 7 7 7 7 1 1 1 1 1 1 1 1 7 1 1 1 1 1 1 1 1 1 1 1 1 1 1 1
1 1 7 34 34 34 34 34 34 7 7 7 7 7 27 27 27 1 1 1 1 1 27 27 27 27 1 1 1 1 1 1 1 1 1 1 1 1 1 1 1 1 1 1 1 1 1 1 1 1
1 3 7 34 34 7 7 7 7 7 7 7 7 7 27 7 27 1 1 1 1 1 27 27 27 27 1 1 1 1 1 1 1 1 1 1 0 1 1 1 1 1 1 1 1 1 1 1 1 1
1 1 7 34 34 34 34 34 34 34 34 37 37 37 37 37 37 37 1 7 1 1 7 7 7 7 1 1 7 1 1 7 1 1 1 1 1 0 1 1 1 1 1 1 1 1 1 1 1 1
1 1 7 34 34 7 7 7 7 7 7 37 37 37 37 37 37 37 1 1 1 1 1 1 1 1 1 1 1 1 1 1 1 1 1 1 1 0 0 0 0 0 0 0 0 0 0 0 0 0
33 33 7 7 7 7 7 7 7 7 7 7 7 7 7 7 7 7 35 35 35 35 35 35 35 35 35 35 35 35 35 35 35 35 35 35 35 2 2 2 2 2 2 2 2 2 2 2 2 2