50 60
2 2 2 2 2 2 2 27 27 27 27 27 27 27 27 27 27 27 27 2 2 2 2 2 2 2 2 2 2 2 2 2 2 2 2 2 2 2 2 2 2 2 2 2 2 2 2 2 2 2
2 2 2 2 2 2 2 27 27 27 27 27 27 27 27 27 27 27 27 2 2 2 2 2 2 2 2 2 2 2 2 2 2 2 2 2 2 2 2 2 2 2 2 2 2 2 2 2 2 2
2 2 2 2 2 2 2 27 27 27 27 27 27 27 27 27 27 27 27 2 2 2 2 2 2 2 2 2 2 2 2 27 27 27 27 27 2 2 2 2 2 27 27 27 27 27 27 27 27 27
2 2 2 2 2 2 2 27 27 27 27 27 27 27 27 27 27 27 27 2 2 2 2 2 2 2 2 2 2 2 27 27 27 27 27 27 27 27 27 27 27 27 27 27 27 27 27 27 27 27
2 2 2 2 2 2 2 27 27 27 27 27 27 27 27 27 27 27 27 2 2 2 2 2 2 2 2 2 2 2 27 27 27 27 27 27 27 27 27 27 27 27 27 27 27 27 27 27 27 27
2 2 2 2 2 2 2 27 27 27 27 27 27 27 27 27 27 27 27 2 2 2 2 2 2 2 2 2 2 27 27 27 27 27 27 27 27 27 27 27 27 27 27 27 27 27 27 27 27 27
2 2 2 2 2 2 2 27 27 27 27 27 27 27 27 27 27 27 27 2 2 2 2 2 2 2 2 2 2 27 27 27 27 27 27 27 27 27 27 27 27 27 27 27 27 27 27 27 27 27
2 2 2 2 2 2 2 27 27 27 27 27 27 27 27 27 27 27 27 2 2 2 2 2 2 2 2 2 2 27 27 27 27 27 27 27 27 27 27 27 27 27 27 27 27 27 2 2 2 2
2 2 2 2 2 2 2 27 27 27 27 27 27 27 27 27 27 27 27 2 2 2 2 2 2 2 2 2 2 27 27 27 27 27 27 27 27 27 27 27 2 2 2 2 2 2 2 2 2 2
2 2 2 2 2 2 2 27 27 27 27 27 27 27 27 27 27 27 27 2 2 2 2 2 2 2 2 2 2 27 27 27 27 27 27 2 2 2 2 2 2 2 2 2 2 2 2 2 2 2
2 2 2 2 2 2 2 27 27 27 27 27 27 27 27 27 27 27 27 2 2 2 2 2 2 2 2 2 2 27 27 27 27 27 2 2 2 2 2 2 2 2 2 2 2 2 2 2 2 2
2 2 2 2 2 2 2 27 27 27 27 27 27 27 27 27 27 27 27 2 2 2 2 2 2 2 2 2 2 2 2 27 27 27 27 27 2 2 29 29 2 2 2 2 2 2 2 2 2 2
2 2 2 2 2 2 2 27 27 27 27 27 27 27 27 27 27 27 27 2 2 2 2 2 2 2 2 2 2 2 2 27 27 27 27 27 27 27 27 27 27 27 27 27 27 2 2 2 2 2
2 2 2 2 2 2 2 27 27 27 27 27 27 27 27 27 27 27 27 2 2 2 2 2 2 2 2 2 2 2 2 2 2 27 27 27 27 27 27 27 27 27 27 27 27 27 2 2 2 2
2 2 2 2 2 2 2 27 27 27 27 27 27 27 27 27 27 27 27 2 2 2 2 2 2 2 2 2 2 2 2 2 2 2 27 27 27 27 27 27 27 27 27 27 27 27 27 2 2 2
2 2 2 2 2 2 2 27 27 27 27 27 27 27 27 27 27 27 27 2 2 2 2 2 2 2 2 2 2 2 2 2 2 2 2 27 27 27 27 27 27 27 27 27 27 27 27 27 2 2
2 2 2 2 2 2 2 27 27 27 27 27 27 27 27 27 27 27 27 2 2 2 2 2 2 2 2 2 2 2 2 2 2 2 2 2 2 2 2 2 2 2 2 27 27 27 27 27 2 2
2 2 2 2 2 2 2 27 27 27 27 27 27 27 27 27 27 27 27 2 2 2 2 2 2 2 2 2 2 2 2 2 2 2 2 2 2 2 2 2 2 2 2 2 2 27 27 27 2 2
2 2 2 2 2 2 2 27 27 27 27 27 27 27 27 27 27 27 27 2 2 2 2 2 2 2 2 2 2 2 2 2 2 2 2 2 2 2 2 2 2 2 2 2 27 27 27 27 2 2
2 2 2 2 2 2 2 27 27 27 27 27 27 27 27 27 27 27 27 2 2 2 2 2 2 2 2 2 2 2 2 2 2 2 2 2 2 2 2 27 27 27 27 27 27 27 27 27 2 2
2 2 2 2 2 2 2 27 27 27 27 27 27 27 27 27 27 27 27 2 2 2 2 2 2 2 2 2 2 2 2 2 2 2 27 27 27 27 27 27 27 27 27 27 27 27 2 2 2 2
2 2 2 2 2 2 2 27 27 27 27 27 27 27 27 27 27 27 27 2 2 2 2 2 2 2 2 2 2 2 2 2 2 27 27 27 27 27 27 27 27 27 27 27 27 2 2 2 2 2
2 2 2 2 2 2 2 27 27 27 27 27 27 27 27 27 27 27 27 2 2 2 2 2 2 2 2 2 2 2 2 27 27 27 27 27 27 27 27 27 27 27 27 27 27 2 2 2 2 2
2 2 2 2 2 2 2 27 27 27 27 27 27 27 27 27 27 27 27 2 2 2 2 2 2 2 2 2 2 27 27 27 27 27 27 27 27 27 27 27 27 27 27 27 2 2 2 2 2 2
2 2 2 2 2 2 2 27 27 27 27 27 27 27 27 27 27 27 27 2 2 2 2 2 2 2 2 2 2 27 27 27 27 27 27 27 27 27 27 27 27 27 27 2 2 2 2 2 2 2
2 2 2 2 2 2 2 27 27 27 27 27 27 27 27 27 27 27 27 2 2 2 2 2 2 2 2 2 2 27 27 27 27 27 27 2 2 28 28 2 28 28 2 2 2 2 2 2 2 2
2 2 2 2 2 2 2 27 27 27 27 27 27 27 27 27 27 27 27 2 2 2 2 2 2 2 2 2 2 27 27 27 27 2 2 2 2 2 2 2 2 2 2 2 2 2 2 2 2 2
2 2 2 2 2 2 2 27 27 27 27 27 27 27 27 27 27 27 27 2 2 2 2 2 2 2 2 2 2 27 27 27 2 2 2 2 2 2 2 2 2 2 2 2 2 2 2 2 2 2
2 2 2 2 2 2 2 27 27 27 27 27 27 27 27 27 27 27 27 2 2 2 2 2 2 2 2 2 2 27 27 27 27 2 2 2 2 2 2 2 2 2 2 2 2 2 2 2 2 2
2 2 2 2 2 2 2 27 27 27 27 27 27 27 27 27 27 27 27 2 2 2 2 2 2 2 2 2 2 27 27 27 27 27 27 27 27 27 27 27 27 27 27 27 27 2 2 2 2 2
2 2 2 2 2 2 2 27 27 27 27 27 27 27 27 27 27 27 27 2 2 2 2 2 2 2 2 2 2 2 27 27 27 27 27 27 27 27 27 27 27 27 27 27 27 27 27 27 27 2
2 2 2 2 2 2 2 27 27 27 27 27 27 27 27 27 27 27 27 2 2 2 2 2 2 2 2 2 2 2 27 27 27 27 27 27 27 27 27 27 27 27 27 27 27 27 27 27 27 27
2 2 2 2 2 2 2 27 27 27 27 27 27 27 27 27 27 27 27 2 2 2 2 2 2 2 2 2 2 2 2 27 27 27 27 27 27 27 27 27 27 27 27 27 27 27 27 27 27 27
2 2 2 2 2 2 2 27 27 27 27 27 27 27 27 27 27 27 27 2 2 2 2 2 2 2 2 2 2 2 2 2 27 27 27 27 27 27 27 27 27 27 27 27 27 27 27 27 27 27
2 2 2 2 2 2 2 27 27 27 27 27 27 27 27 27 27 27 27 2 2 2 2 2 2 2 2 2 2 2 2 2 2 2 2 2 27 27 27 27 27 27 27 27 27 27 27 27 27 27
2 2 2 2 2 2 2 27 27 27 27 27 27 27 27 27 27 27 27 2 2 2 2 2 2 2 2 2 2 2 2 2 2 2 2 2 2 2 2 2 2 2 2 27 27 27 27 27 27 27
2 2 2 2 2 2 2 27 27 27 27 27 27 27 27 27 27 27 27 2 2 2 2 2 2 2 2 2 2 2 2 2 2 2 2 2 2 2 2 2 2 2 2 2 30 30 30 30 30 30
2 2 2 2 2 2 2 27 27 27 27 27 27 27 27 27 27 27 27 2 2 2 2 2 2 2 2 2 2 2 2 2 2 2 2 2 2 2 2 2 2 2 2 2 2 31 31 31 31 31
2 2 2 2 2 2 2 27 27 27 27 27 27 27 27 27 27 27 27 2 2 2 2 2 2 2 2 2 2 2 2 2 2 2 2 2 2 2 2 2 2 2 2 2 2 2 31 31 31 31
2 2 2 2 2 2 2 27 27 27 27 27 27 27 27 27 27 27 27 2 2 2 2 2 2 2 2 2 2 2 2 2 2 2 2 2 2 2 2 2 2 2 2 2 2 2 31 31 31 31
2 2 2 2 2 2 2 27 27 27 27 27 27 27 27 27 27 27 27 2 2 2 2 2 2 2 2 2 2 2 2 27 27 27 27 27 27 27 27 2 2 2 2 2 2 2 31 31 31 31
2 2 2 2 2 2 2 27 27 27 27 27 27 27 27 27 27 27 27 2 2 2 2 2 2 2 2 2 2 27 27 27 27 27 27 27 27 27 27 27 2 2 2 2 2 2 31 31 31 31
2 2 2 2 2 2 2 27 27 27 27 27 27 27 27 27 27 27 27 2 2 2 2 2 2 2 2 2 27 27 27 27 27 27 27 27 27 27 27 27 27 2 2 2 2 2 31 31 31 31
2 2 2 2 2 2 2 27 27 27 27 27 27 27 27 27 27 27 27 2 2 2 2 2 2 2 2 27 27 27 27 27 27 27 27 27 27 27 27 27 27 2 2 2 2 2 2 31 31 31
2 2 2 2 2 2 2 27 27 27 27 27 27 27 27 27 27 27 27 2 2 2 2 2 2 2 2 27 27 27 27 27 27 27 27 27 27 27 27 27 27 2 2 2 2 2 2 31 31 31
2 2 2 2 2 2 2 27 27 27 27 27 27 27 27 27 27 27 27 2 2 2 2 2 2 2 2 27 27 27 27 27 27 27 27 27 27 27 27 27 27 2 2 2 2 2 31 31 31 31
2 2 2 2 2 2 2 27 27 27 27 27 27 27 27 27 27 27 27 2 2 2 2 2 2 2 27 27 27 27 27 27 27 27 27 27 2 30 30 30 30 2 31 31 31 31 31 31 31 31
2 2 2 2 2 2 2 27 27 27 27 27 27 27 27 27 27 27 27 2 2 2 2 2 2 27 27 27 27 27 27 27 27 27 2 2 2 31 31 31 31 31 31 31 31 31 31 31 31 31
2 2 2 2 2 2 2 27 27 27 27 27 27 27 27 27 27 27 27 2 2 2 2 2 2 27 27 27 27 27 27 27 27 27 2 2 2 31 31 31 31 31 31 31 31 31 31 31 31 31
2 2 2 2 2 2 2 27 27 27 27 27 27 27 27 27 27 27 27 2 2 2 2 2 27 27 27 27 27 27 27 27 27 27 2 2 2 31 31 31 31 31 31 31 31 31 31 31 31 31
2 2 2 2 2 2 2 27 27 27 27 27 27 27 27 27 27 27 27 27 27 27 27 27 27 27 27 27 27 27 27 27 27 27 2 2 2 31 31 31 31 31 31 31 31 31 31 31 31 2
2 2 2 2 2 2 2 27 27 27 27 27 27 27 27 27 27 27 27 27 27 27 27 27 27 27 27 27 27 27 27 27 27 2 2 2 2 31 31 31 31 31 31 31 31 31 31 31 31 2
2 2 2 2 2 2 2 2 27 27 27 27 27 27 27 27 27 27 27 27 27 27 27 27 27 27 27 27 27 27 27 27 2 2 2 2 2 31 31 31 31 31 31 31 31 31 31 31 31 2
2 2 2 2 2 2 2 2 2 27 27 27 27 27 27 27 27 27 27 27 27 27 27 27 27 27 27 27 27 27 27 27 2 2 2 2 2 31 31 31 31 31 31 31 31 31 31 31 2 2
2 2 2 2 2 2 2 2 2 2 27 27 27 27 27 27 27 27 27 27 27 27 27 27 27 27 27 27 27 27 2 2 2 2 2 2 2 2 2 31 31 31 31 31 31 31 2 2 2 2
2 2 2 2 2 2 2 2 2 2 2 2 2 2 2 2 2 2 2 2 2 2 2 2 2 2 2 2 2 2 2 2 2 2 2 2 2 2 2 2 2 2 2 2 2 2 2 2 2 2
2 2 2 2 2 2 2 2 2 2 2 2 2 2 2 2 2 2 2 2 2 2 2 2 2 2 2 2 2 2 2 2 2 2 2 2 2 2 2 2 2 2 2 2 2 2 2 2 2 2
2 2 2 2 2 2 2 2 2 2 2 2 2 2 2 2 2 2 2 2 2 2 2 2 2 2 2 2 2 2 2 2 2 2 2 2 2 2 2 2 2 2 2 2 2 2 2 2 2 2
2 2 2 2 2 2 2 2 2 2 2 2 2 2 2 2 2 2 2 2 2 2 2 2 2 2 2 2 2 2 2 2 2 2 2 2 2 2 2 2 2 2 2 2 2 2 2 2 2 2
2 2 2 2 2 2 2 2 2 2 2 2 2 2 2 2 2 2 2 2 2 2 2 2 2 2 2 2 2 2 2 2 2 2 2 2 2 2 2 2 2 2 2 2 2 2 2 2 2 2