50 23
1 1 1 1 1 1 1 1 1 1 1 1 1 1 1 1 1 1 1 1 1 1 1 1 1 1 1 1 1 1 1 1 1 1 1 1 1 1 1 1 1 1 1 1 1 1 1 1 1 1
1 1 1 1 1 1 1 1 1 1 1 1 1 1 1 1 1 1 1 1 1 1 1 1 1 1 1 1 1 1 1 1 1 1 1 1 1 1 1 1 1 1 1 1 1 1 1 1 1 1
1 1 1 1 1 1 1 1 1 1 1 1 1 1 1 1 1 1 1 1 1 1 1 1 1 1 1 1 1 1 1 1 1 1 1 1 1 1 1 1 1 1 1 1 1 1 1 1 1 1
1 1 1 1 1 1 1 1 1 1 1 1 1 1 1 1 1 1 1 1 1 1 1 1 1 1 1 1 1 1 1 1 1 1 1 1 1 1 1 1 1 1 1 1 1 1 1 1 1 1
1 1 1 1 1 1 1 1 1 1 1 1 1 1 1 1 1 1 1 1 1 1 1 1 1 1 1 1 1 1 1 1 1 1 1 1 1 1 1 1 1 1 1 1 1 1 1 1 1 1
1 1 1 1 1 1 1 1 1 1 1 1 1 1 1 1 1 1 1 1 1 8 8 8 8 8 8 1 1 1 1 1 1 1 1 1 1 1 1 1 1 1 1 1 1 1 1 1 1 1
0 0 0 0 0 0 0 1 1 1 1 1 1 1 1 1 1 1 1 1 8 8 8 8 8 8 8 8 1 1 1 0 0 0 1 1 1 1 1 1 1 1 1 1 1 1 1 1 1 1
0 0 0 0 0 0 0 0 1 1 1 1 1 1 1 1 1 1 1 1 8 8 8 8 8 8 8 8 1 1 0 0 0 0 0 1 1 1 1 1 1 1 1 1 1 1 1 1 1 1
0 0 0 0 0 0 0 0 0 0 0 0 0 0 0 0 0 1 1 1 8 8 8 8 8 8 8 8 1 1 2 2 2 2 0 0 0 0 0 0 1 1 1 1 1 1 1 1 1 1
2 2 2 2 2 2 2 0 0 0 0 0 0 0 0 2 2 1 1 1 1 8 8 8 8 8 8 1 1 1 27 27 27 2 2 0 0 0 0 0 0 1 1 1 1 1 1 1 1 1
2 2 2 2 2 2 2 2 0 0 0 0 2 2 2 2 2 1 1 1 1 1 1 7 7 1 1 1 1 1 27 27 27 27 2 2 2 2 2 2 0 0 1 1 1 1 1 1 1 1
2 2 2 2 2 2 2 2 2 2 2 2 2 2 2 2 2 1 1 1 1 1 1 7 7 1 1 1 1 1 27 27 27 27 27 2 2 2 2 2 2 0 0 1 1 1 1 1 1 1
2 2 2 2 2 2 2 2 2 2 2 2 2 2 2 2 2 1 1 1 1 1 1 12 7 1 1 1 1 2 2 27 27 27 27 27 27 27 27 27 2 2 0 0 1 1 1 1 1 1
2 2 2 2 2 2 2 2 2 2 2 2 2 2 2 2 1 1 1 1 1 1 1 13 7 11 6 1 1 2 2 2 2 27 27 27 27 27 27 27 27 2 2 0 1 1 1 1 1 1
16 16 16 16 16 16 16 16 16 16 16 2 2 2 2 2 1 1 1 1 5 11 11 7 7 1 1 1 1 2 2 2 2 2 27 27 27 27 27 27 27 27 2 2 1 1 1 1 1 1
16 16 16 16 16 16 16 16 16 16 16 2 2 2 2 2 1 1 1 1 1 1 1 7 7 1 1 1 1 2 2 2 2 2 2 27 27 27 27 27 27 27 27 27 1 1 1 1 1 1
16 16 16 16 16 16 16 16 16 16 16 16 2 2 2 2 1 1 1 1 1 1 1 7 7 6 1 1 1 16 2 2 2 2 2 2 27 27 27 27 27 27 27 27 1 1 1 1 1 1
16 16 16 16 16 16 16 16 16 16 16 16 2 2 2 2 1 1 1 1 1 1 1 27 27 1 1 1 16 16 16 2 2 2 2 2 27 27 27 27 27 27 27 27 1 1 1 1 1 1
16 16 16 16 16 16 16 16 16 16 16 16 2 2 2 2 1 1 1 1 1 1 1 27 27 1 1 1 16 16 16 16 2 2 2 2 27 27 27 27 27 27 2 2 0 0 0 0 0 0
16 16 16 16 16 16 16 16 16 16 16 16 2 2 2 2 1 1 1 1 1 1 1 7 7 1 1 1 16 16 16 16 2 2 2 2 2 2 2 2 2 2 2 2 0 0 0 0 0 0
16 16 16 16 16 16 16 16 16 16 16 16 16 2 2 2 0 0 0 0 0 0 0 0 0 0 0 0 2 16 16 2 2 2 2 2 2 2 16 16 2 2 2 2 2 2 2 2 2 2
16 16 16 16 16 16 16 16 16 16 16 16 16 2 2 2 2 0 0 0 0 0 0 0 0 0 0 0 2 2 2 2 2 2 2 16 16 16 16 16 16 16 16 16 2 2 2 2 2 2
16 16 16 16 16 16 16 16 16 16 16 16 16 2 2 2 2 2 2 0 0 0 0 0 0 0 0 2 2 2 2 2 2 2 16 16 16 16 16 16 16 16 16 16 16 16 16 16 2 2