54 17
18 18 18 18 18 18 18 18 18 18 18 18 18 18 18 18 18 18 18 18 18 18 18 18 18 18 18 18 18 18 18 18 18 18 18 18 18 18 18 18 18 18 18 18 18 18 18 18 18 18 18 20 20 20
18 18 18 18 18 18 18 18 18 18 18 18 18 18 18 18 18 18 18 18 18 18 18 18 18 18 18 18 18 18 18 18 18 18 18 18 18 18 18 18 18 18 18 18 18 18 18 18 18 18 20 20 20 20
18 18 18 18 18 18 18 18 18 18 18 18 18 18 18 18 18 18 18 18 18 18 18 18 18 18 18 18 18 18 18 18 18 18 18 18 18 18 18 18 20 20 20 20 20 18 18 18 18 20 20 20 20 20
18 18 18 18 18 18 18 18 18 18 18 18 18 18 18 18 18 18 18 18 18 18 18 18 18 18 18 18 18 18 18 18 18 18 18 18 18 18 18 20 20 20 20 20 20 20 18 18 20 20 20 20 20 20
18 18 18 18 18 18 18 18 18 18 18 18 18 18 18 18 18 18 20 18 18 18 20 18 18 18 18 18 18 18 18 18 18 18 18 18 18 18 18 20 19 20 20 20 20 20 18 20 20 20 20 20 20 20
18 18 18 18 18 18 18 20 20 20 20 20 18 18 18 18 25 24 20 20 20 20 20 18 18 18 18 18 18 18 18 18 18 18 18 18 18 18 18 19 19 20 20 20 20 18 18 20 20 20 20 20 20 20
18 18 18 18 18 18 18 20 20 20 20 20 18 18 18 18 18 18 20 20 20 20 20 18 18 18 18 18 18 18 18 18 18 18 18 18 18 18 18 20 20 20 20 27 27 18 18 18 20 20 19 20 20 20
18 18 18 18 18 18 20 20 20 20 20 20 20 26 18 18 18 18 18 19 19 20 18 18 18 18 18 18 18 18 18 18 18 18 18 18 18 18 18 20 19 19 19 19 27 18 18 18 18 20 19 19 20 20
20 18 18 18 18 18 18 20 20 20 20 20 18 18 18 18 18 18 18 19 19 18 18 18 18 18 18 18 18 18 18 18 18 18 18 18 18 18 20 20 19 27 27 27 27 18 18 18 18 18 19 19 19 20
20 20 18 18 18 18 18 18 18 19 18 18 18 18 18 18 18 18 18 19 19 18 18 18 18 20 20 18 20 20 20 18 18 18 18 18 18 18 20 19 19 27 27 27 18 18 18 18 18 18 27 27 27 27
19 18 18 18 18 25 24 24 24 19 18 18 18 18 18 18 18 18 18 19 19 18 18 18 18 20 20 24 20 20 20 26 18 18 18 18 18 18 18 27 27 18 27 27 27 18 18 18 18 18 27 27 27 27
19 18 18 18 18 18 18 18 18 19 18 18 18 18 18 18 18 18 18 19 19 18 18 18 18 18 18 18 20 20 20 18 18 18 18 18 18 18 18 27 27 27 19 19 19 27 18 18 18 18 27 27 27 27
19 24 26 18 18 18 18 18 18 27 18 18 18 18 18 18 18 18 18 27 27 18 18 18 25 20 20 20 20 20 20 18 18 18 18 18 18 18 18 18 27 19 19 19 19 19 18 18 18 18 27 27 27 27
19 18 18 18 18 25 24 24 24 19 26 18 18 18 18 18 18 18 25 19 19 26 18 18 18 18 18 19 19 18 18 18 18 18 18 18 18 18 18 18 27 27 19 18 27 27 18 18 18 25 19 19 19 19
19 18 18 18 18 18 18 18 18 19 18 18 18 18 18 18 18 18 18 19 19 18 18 18 18 18 18 19 19 18 18 18 18 18 19 19 19 19 18 18 27 27 18 18 27 27 18 18 18 18 19 19 19 19
19 22 22 22 22 22 22 22 22 19 22 22 22 22 22 22 22 22 22 19 19 22 22 22 22 22 22 19 19 22 22 22 22 22 19 19 19 19 22 22 19 27 27 27 19 19 19 22 22 22 19 19 19 19
19 23 23 23 23 23 23 23 23 19 23 23 23 23 23 23 23 23 23 19 19 23 23 23 23 23 23 19 19 23 23 23 23 23 19 19 19 19 23 23 19 19 19 19 19 19 19 23 23 23 19 19 19 19