50 55
1 1 1 1 1 1 1 1 1 1 1 1 1 1 1 1 1 1 1 1 1 1 1 1 1 1 1 1 1 1 1 1 1 1 1 1 1 1 1 1 1 1 1 1 1 1 1 1 1 1
3 1 1 1 1 1 1 1 1 1 1 1 1 1 1 1 1 1 1 1 1 1 1 1 1 1 1 1 1 1 1 1 1 1 1 1 1 1 1 1 1 1 1 1 1 1 1 1 1 1
1 1 1 1 1 1 1 1 1 1 1 1 1 1 1 1 1 1 1 1 1 1 1 1 1 1 1 1 1 1 1 1 1 1 1 1 1 1 1 1 1 1 1 1 1 1 1 1 1 1
1 1 1 1 1 1 1 1 1 1 1 1 1 1 1 1 1 1 1 1 1 1 1 1 1 1 1 1 1 1 1 1 1 1 1 1 1 1 1 1 1 1 1 1 1 1 1 1 1 1
1 1 1 1 1 1 16 16 16 16 16 16 1 1 1 1 1 1 1 1 1 1 1 1 1 1 1 1 1 1 1 1 1 1 1 1 1 1 1 1 1 1 1 1 1 1 1 1 1 1
1 1 1 1 1 1 16 16 16 16 16 16 1 1 1 1 1 1 1 1 1 1 1 1 1 1 1 1 1 1 1 1 1 1 1 1 1 1 1 1 1 1 1 1 1 1 1 1 1 1
0 10 1 1 1 1 16 16 16 16 16 16 1 1 1 1 1 1 1 1 1 1 1 1 1 1 1 1 1 1 1 1 1 1 1 1 1 1 1 1 1 1 1 1 1 1 1 1 1 1
2 0 9 1 1 1 1 1 32 32 16 16 1 1 1 1 1 1 1 1 1 1 1 1 1 1 1 1 1 1 16 16 16 16 16 16 1 1 1 1 1 1 1 1 1 1 1 1 1 1
2 2 0 9 9 10 1 1 32 32 16 16 1 1 1 1 1 1 1 1 1 1 1 1 1 16 16 16 16 16 16 32 32 32 32 32 16 16 16 1 1 1 1 1 1 1 1 1 1 1
2 2 2 0 0 0 16 1 32 32 32 16 16 1 1 1 1 1 1 1 1 1 1 1 16 16 32 32 32 32 32 32 32 32 32 32 32 32 16 16 16 16 16 16 1 1 1 1 1 1
2 2 2 2 2 2 16 16 32 32 32 32 16 16 16 16 16 16 16 16 16 16 16 16 16 32 32 32 32 32 32 32 32 32 32 32 32 32 32 32 32 32 32 16 1 1 1 1 1 1
2 2 2 2 2 2 2 16 16 32 32 32 32 32 32 32 32 32 32 32 32 32 32 32 32 32 32 32 32 32 32 32 32 32 32 32 32 32 32 32 32 32 32 16 1 1 1 1 1 1
2 2 2 2 2 2 2 2 16 16 32 32 32 32 32 32 32 32 32 32 32 32 32 32 32 32 32 32 32 32 16 16 16 16 16 32 32 32 32 32 32 32 32 16 1 1 1 1 1 1
2 2 2 2 2 2 2 2 2 16 16 32 32 32 32 32 32 32 32 32 32 32 32 32 32 32 32 32 32 16 16 16 16 16 16 32 32 32 32 32 32 32 32 16 1 1 1 1 1 1
16 16 16 16 16 16 16 16 16 16 16 32 32 32 32 32 32 32 32 32 32 32 32 32 32 32 32 16 16 16 16 16 16 16 16 16 32 32 16 16 16 32 32 16 1 1 1 1 1 1
16 16 16 16 16 16 16 16 16 16 16 16 32 32 32 32 32 32 16 32 32 32 32 32 32 32 32 16 16 16 16 16 16 16 16 16 32 32 32 32 16 16 16 16 1 1 1 1 1 1
16 16 16 16 16 16 16 16 16 16 16 16 32 32 16 16 16 16 16 16 16 16 16 16 16 16 16 16 16 16 16 16 16 16 16 16 32 32 32 32 32 32 16 1 1 1 1 1 1 1
16 16 16 16 16 16 16 16 16 32 32 32 32 32 16 16 16 16 16 16 16 16 16 16 16 16 16 16 16 16 16 16 16 16 16 16 16 32 32 32 32 32 16 16 1 1 1 1 1 1
16 16 16 16 16 16 16 32 32 32 32 32 32 32 16 16 16 16 16 16 16 16 16 16 16 16 16 16 16 16 16 16 16 16 16 32 16 16 16 32 32 32 32 16 1 1 1 1 1 1
16 16 16 16 16 16 16 32 32 32 32 32 16 16 16 16 16 16 16 16 16 16 32 32 16 16 32 32 32 32 32 32 32 16 16 32 32 32 16 16 32 32 32 16 1 1 1 1 1 1
16 16 16 16 16 32 32 32 32 16 16 16 16 16 16 16 32 32 32 32 32 32 32 32 32 32 32 32 32 32 32 32 32 32 32 32 32 32 32 16 32 32 32 32 16 1 1 1 1 1
16 16 16 16 16 32 32 32 32 16 16 16 16 16 16 32 32 32 32 32 32 32 32 32 32 32 32 32 32 32 32 32 32 32 32 32 32 16 16 16 32 32 32 32 16 16 16 16 16 16
16 16 16 32 32 32 32 32 16 16 16 16 16 16 32 32 32 32 32 32 32 32 32 32 32 32 32 32 32 32 32 32 32 32 32 16 16 16 32 32 32 32 32 16 16 16 16 16 16 16
16 16 16 32 32 32 32 16 16 16 16 16 16 16 32 32 32 32 32 16 32 32 32 32 32 16 16 16 16 16 32 32 32 32 16 16 32 32 32 32 32 32 16 16 16 16 16 16 16 16
16 16 16 32 32 32 16 16 16 16 16 16 16 32 32 32 32 16 16 16 32 32 32 32 32 16 16 16 16 16 16 32 32 16 16 32 32 32 32 32 32 32 16 16 16 16 16 16 16 16
16 16 16 32 32 32 32 16 16 16 16 32 32 32 32 32 16 16 16 16 32 32 32 32 32 16 16 16 16 16 16 16 16 16 32 32 32 32 32 32 16 16 16 16 16 16 16 16 16 16
16 16 16 32 32 32 32 32 32 32 32 32 32 32 32 16 16 16 16 16 32 32 32 32 32 16 16 16 16 16 32 32 32 32 32 32 32 32 32 32 16 16 16 16 16 16 16 16 16 16
16 16 16 16 32 32 32 32 32 32 32 32 32 32 16 16 16 16 16 16 32 32 32 32 32 16 16 16 16 16 32 32 32 32 32 32 32 32 16 16 16 16 16 16 16 16 16 16 16 16
16 16 16 16 16 16 16 16 16 16 16 16 16 16 16 16 16 16 16 16 32 32 32 32 32 16 16 16 16 32 32 32 32 32 32 32 32 32 16 16 16 16 16 16 16 16 16 16 16 16
16 16 16 16 16 16 16 16 16 16 16 16 16 16 16 16 16 16 16 16 32 32 32 32 32 16 16 16 16 16 16 32 32 32 32 32 32 32 16 16 16 16 16 16 16 16 16 16 16 16
16 16 16 16 16 16 16 16 16 16 16 16 16 16 16 16 16 16 16 16 32 32 32 32 32 16 16 16 16 16 16 16 16 16 16 16 16 16 16 16 16 16 16 16 16 16 16 16 16 16
16 16 16 16 16 16 16 16 16 16 16 16 16 16 16 16 16 16 16 16 32 32 32 32 32 16 16 16 16 16 16 16 16 16 16 16 16 16 16 16 16 16 16 16 16 16 16 16 16 16
16 16 16 16 16 16 16 16 16 16 16 16 16 16 16 16 16 16 16 16 32 32 32 32 32 16 16 16 16 16 16 16 16 16 16 16 16 16 16 16 16 16 16 16 16 16 16 16 16 16
16 16 16 16 16 16 16 16 16 16 16 16 16 16 16 16 16 16 37 37 32 32 32 32 32 37 37 16 16 16 16 16 16 16 16 16 16 16 16 16 16 16 16 16 16 16 16 16 16 16
16 16 16 16 16 16 16 16 16 16 16 16 16 16 16 16 16 16 37 37 32 32 32 32 32 37 37 16 16 16 16 16 16 16 16 16 16 16 16 16 16 16 16 16 16 16 16 16 16 16
16 16 16 16 16 16 16 16 16 16 16 16 16 16 16 16 16 16 37 37 32 32 32 32 32 37 37 16 16 16 16 16 16 16 16 16 16 16 16 16 16 16 16 16 16 16 16 16 16 16
16 16 16 16 16 16 16 16 16 16 16 16 16 16 16 16 16 16 37 37 32 32 32 32 32 37 37 16 16 16 16 16 16 16 16 16 16 16 16 16 16 16 16 16 16 16 16 16 16 16
16 16 16 16 16 16 16 16 16 16 16 16 16 16 16 16 16 16 37 37 32 32 32 32 32 37 37 16 16 16 16 16 16 16 16 16 16 16 16 16 16 16 16 16 16 16 16 16 16 16
16 16 16 16 16 16 16 16 16 16 16 16 16 16 16 16 16 16 37 37 32 32 32 32 32 37 37 16 16 16 16 16 16 16 16 16 16 16 16 16 16 16 16 16 16 16 16 16 16 16
16 16 16 16 16 16 16 16 16 16 16 16 16 16 16 16 16 16 37 37 32 32 32 32 32 37 37 37 37 37 37 37 37 37 37 37 37 37 37 37 41 41 41 41 41 41 41 41 41 41
16 16 16 16 16 16 16 16 16 16 16 16 16 16 16 16 16 16 37 37 32 32 32 32 32 37 37 37 37 37 37 37 37 37 37 37 37 37 37 37 41 41 41 41 41 41 41 41 41 41
16 16 16 16 16 16 16 16 16 16 16 16 16 16 16 16 16 16 37 37 32 32 32 32 32 37 37 37 37 37 37 37 37 37 37 37 37 37 37 37 41 41 41 41 41 41 41 41 41 41
16 16 16 16 16 16 16 16 16 16 16 16 16 16 16 16 16 16 37 37 32 32 32 32 32 36 36 36 36 36 36 36 44 36 44 36 44 36 44 36 47 40 47 40 47 40 47 40 47 40
16 16 16 16 16 16 16 16 16 16 16 16 16 16 16 16 16 16 37 37 32 32 32 32 32 32 32 32 32 32 32 32 42 32 42 32 42 32 42 32 45 38 45 38 45 38 45 38 45 38
16 16 16 16 16 16 16 16 16 16 16 16 16 16 16 16 16 16 37 37 32 32 32 32 32 32 32 32 32 32 32 32 42 32 42 32 42 32 42 32 45 38 45 38 45 38 45 38 45 38
16 16 16 16 16 16 16 16 16 16 16 16 16 16 16 16 16 16 37 37 37 37 37 37 37 37 37 37 37 37 32 32 42 32 42 32 42 32 42 32 45 38 45 38 45 38 45 38 45 38
16 16 16 16 16 16 16 16 16 16 16 16 16 16 16 16 16 16 37 37 37 37 37 37 37 37 37 37 37 37 37 32 42 32 42 32 42 32 42 32 45 38 45 38 45 38 45 38 45 38
16 16 16 16 16 16 16 16 16 16 16 16 16 16 16 16 16 16 37 37 37 37 37 37 37 37 37 37 37 37 37 32 43 32 43 32 43 32 43 32 46 38 46 38 46 38 46 38 46 38
16 16 16 16 16 16 16 16 16 16 16 16 16 16 16 16 16 16 37 37 37 37 37 37 37 37 37 37 37 37 37 37 37 37 37 37 37 37 37 37 41 41 41 41 41 41 41 41 41 41
16 16 16 16 16 16 16 16 16 16 16 16 16 16 16 16 16 16 37 37 37 37 37 37 37 37 37 37 37 37 37 37 37 37 37 37 37 37 37 37 41 41 41 41 41 41 41 41 41 41
16 16 16 16 16 16 16 16 16 16 16 16 16 16 16 16 16 16 37 37 37 37 37 37 37 37 37 37 37 37 37 37 37 37 37 37 37 37 37 37 41 41 41 41 41 41 41 41 41 41
16 16 16 16 16 16 16 16 16 16 16 16 16 16 16 16 16 16 16 16 16 16 16 16 16 16 16 16 16 16 16 16 16 16 16 16 16 16 16 16 16 16 16 16 16 16 16 16 16 16
16 16 16 16 16 16 16 16 16 16 16 16 16 16 16 16 16 16 16 16 16 16 16 16 16 16 16 16 16 16 16 16 16 16 16 16 16 16 16 16 16 16 16 16 16 16 16 16 16 16
16 16 16 16 16 16 16 16 16 16 16 16 16 16 16 16 16 16 16 16 16 16 16 16 16 16 16 16 16 16 16 16 16 16 16 16 16 16 16 16 16 16 16 16 16 16 16 16 16 16
16 16 16 16 16 16 16 16 16 16 16 16 16 16 16 16 16 16 16 16 16 16 16 16 16 16 16 16 16 16 16 16 16 16 16 16 16 16 16 16 16 16 16 16 16 16 16 16 16 16