54 19
16 16 16 16 16 16 16 16 16 16 16 16 16 16 16 16 16 16 16 16 16 16 16 16 16 16 16 16 16 16 16 16 16 16 16 16 16 16 16 16 16 16 16 16 16 16 16 16 16 16 16 16 16 16
16 16 16 16 16 16 16 16 16 16 16 16 16 16 16 16 16 16 16 16 16 16 16 16 16 32 32 32 32 32 32 32 16 16 16 16 16 16 16 16 16 16 16 16 16 16 16 16 16 16 16 16 16 16
32 32 32 16 16 16 16 16 16 32 32 32 16 16 16 16 16 16 32 32 32 32 16 16 16 32 32 32 32 32 32 32 32 32 32 32 32 16 16 16 16 16 16 16 16 16 16 16 16 16 16 16 16 16
32 32 32 16 16 16 16 16 16 32 32 32 16 16 16 16 16 16 32 32 32 32 16 16 32 32 32 32 32 32 32 32 32 32 32 32 32 32 32 16 16 16 16 16 16 16 16 16 16 16 16 16 16 16
32 32 32 32 16 16 16 16 16 32 32 32 16 16 16 16 16 32 32 32 32 32 16 16 32 32 32 32 32 32 32 32 32 32 32 32 32 32 32 16 16 16 16 16 16 16 16 16 16 16 16 16 16 16
32 32 32 32 16 16 16 32 32 32 32 32 32 16 16 16 32 32 32 32 32 32 16 32 32 32 32 32 16 16 16 16 16 16 16 32 32 32 32 32 32 16 16 16 32 32 16 16 16 16 16 32 32 32
32 32 32 32 16 16 16 32 32 32 32 32 32 32 16 16 32 32 32 32 32 32 16 16 16 16 32 32 32 32 16 16 16 16 32 32 32 32 32 32 32 32 16 16 32 32 32 16 16 32 32 32 32 32
32 32 32 32 16 16 32 32 32 32 32 32 32 32 16 32 32 32 32 32 32 32 16 32 32 32 32 32 32 32 32 16 16 16 32 32 33 32 32 32 32 32 16 16 32 32 32 16 32 32 32 32 32 32
32 32 32 32 32 16 32 32 32 32 32 32 32 32 16 32 32 32 32 32 32 32 16 32 32 32 32 32 32 32 32 32 16 16 32 32 16 32 32 32 32 32 32 16 32 32 32 16 32 32 32 32 32 32
32 32 32 32 32 32 32 32 32 32 32 32 32 32 16 32 32 32 32 32 32 32 16 16 16 16 16 32 32 32 32 32 16 16 32 32 32 32 33 32 32 32 32 32 32 32 32 32 32 32 32 32 32 32
32 32 32 32 32 32 32 32 32 32 32 32 32 32 32 32 32 32 32 32 32 32 32 32 32 32 32 32 32 16 16 16 16 16 32 32 32 32 16 32 32 32 32 32 32 32 32 32 32 32 32 32 32 32
32 32 32 32 32 32 32 32 32 32 32 32 32 32 32 32 32 32 32 32 32 32 32 32 32 32 32 32 32 32 32 16 16 16 32 33 32 32 32 32 32 32 32 32 32 32 32 32 32 32 32 32 32 32
32 32 32 32 32 32 32 32 32 32 21 32 32 32 32 32 32 32 32 21 32 32 32 32 32 32 32 32 32 32 32 16 16 16 32 16 32 32 32 32 32 32 32 32 32 32 32 32 32 32 32 32 32 32
32 32 32 32 32 32 32 32 32 32 16 16 16 16 16 16 16 16 16 16 32 32 32 32 16 32 32 32 16 16 16 16 16 16 32 32 32 32 32 32 32 32 35 32 32 35 32 32 32 32 32 32 21 21
32 32 32 32 32 32 32 16 32 32 32 32 32 32 32 32 32 32 32 32 32 32 32 16 16 32 32 32 32 32 16 16 16 16 32 32 32 32 32 32 32 32 36 32 32 36 32 32 32 32 21 21 16 16
32 32 32 32 32 32 16 16 32 32 32 32 32 32 32 32 32 32 32 32 32 32 32 16 16 32 32 32 32 16 16 16 16 16 32 32 32 21 21 32 32 32 32 32 32 32 32 32 32 32 16 16 16 16
32 32 32 32 32 32 16 16 16 32 32 32 32 32 32 32 32 32 32 32 32 32 21 16 16 21 33 33 33 16 16 16 16 16 21 32 32 16 16 32 32 32 32 32 32 32 32 32 32 32 16 16 16 16
32 32 32 32 32 16 16 16 16 16 33 33 33 33 33 33 33 33 33 33 21 21 21 16 16 16 34 34 34 16 16 16 16 16 16 33 33 33 33 33 33 33 33 33 33 33 33 33 33 33 16 16 16 16
21 21 21 21 21 16 16 16 16 16 34 34 34 34 34 34 34 34 34 34 16 16 16 16 16 16 16 16 16 16 16 16 16 16 16 34 34 34 34 34 34 34 34 34 34 34 34 34 34 34 16 16 16 16