
34 26
18 18 18 7 7 18 18 18 18 18 18 18 18 18 18 18 18 18 18 18 7 7 7 7 7 18 18 18 18 18 18 18 18 18
18 18 18 7 7 18 18 18 18 18 18 18 18 18 18 18 18 18 18 18 7 7 7 7 7 18 18 18 18 18 18 18 18 18
7 7 18 7 7 18 18 18 18 18 18 18 18 18 18 18 18 18 18 18 7 7 7 7 7 18 18 18 18 18 18 18 18 18
7 7 18 7 7 18 18 18 18 18 18 18 18 18 18 18 18 18 18 18 7 7 7 7 7 18 18 18 18 18 18 18 18 18
7 7 18 7 7 18 18 18 18 18 18 18 18 18 18 18 18 18 18 18 7 7 7 7 7 18 18 18 18 18 18 18 18 18
7 7 18 7 7 18 18 18 18 18 18 18 18 18 18 18 18 18 18 18 7 7 7 7 7 18 18 18 18 18 18 18 18 18
7 7 18 7 7 18 18 18 18 18 18 18 18 18 18 18 18 18 18 18 7 7 7 7 7 18 18 18 18 18 18 18 18 18
7 7 18 7 7 18 18 18 18 18 20 20 20 20 18 18 18 18 18 18 7 7 7 7 7 18 18 18 18 18 18 18 18 18
4 7 18 7 7 18 18 18 18 18 20 20 20 20 18 18 18 18 18 18 7 7 7 7 7 18 18 18 18 18 18 18 18 18
7 7 18 7 7 7 18 18 18 18 18 7 7 18 18 18 18 18 18 18 7 7 7 7 7 18 18 18 18 18 18 18 18 18
7 7 18 18 7 7 18 18 18 18 18 7 7 18 18 18 18 18 18 18 7 7 7 7 7 18 18 18 18 18 18 18 18 18
7 7 18 18 7 7 18 18 18 18 18 7 7 18 18 18 18 18 18 18 7 7 7 7 7 18 18 18 18 18 18 18 18 18
7 27 18 18 27 27 18 18 18 18 18 7 7 18 18 18 18 18 18 18 7 7 7 7 7 18 18 18 18 18 18 18 18 18
7 27 18 18 27 27 18 18 18 18 18 7 7 18 18 18 18 18 18 18 7 7 7 7 7 18 18 18 18 18 18 18 18 18
7 7 7 7 7 7 7 7 18 18 18 27 27 18 18 18 18 18 18 18 7 7 7 7 7 18 18 18 18 18 18 18 18 18
7 7 18 18 7 7 18 7 7 18 18 27 27 18 18 18 18 18 18 18 7 7 7 7 7 18 18 18 18 18 18 18 18 18
7 7 18 18 7 7 18 18 18 18 18 7 7 18 18 18 18 18 18 18 7 7 7 7 7 18 18 18 18 18 18 18 18 18
7 7 18 18 7 7 18 18 18 18 18 7 7 18 18 18 18 18 18 18 7 7 7 7 7 18 18 18 18 18 18 18 18 18
7 7 18 18 7 7 18 18 18 18 18 7 7 18 18 18 18 18 18 18 27 27 27 27 27 18 18 18 18 18 18 18 18 18
7 7 18 18 7 7 18 18 18 18 18 7 7 7 7 18 18 18 18 18 27 27 27 27 27 18 18 18 18 18 18 18 18 18
7 7 18 18 7 7 18 18 18 18 18 7 7 18 18 18 18 18 18 18 27 27 27 27 27 18 18 18 18 18 18 18 18 18
7 7 18 18 7 7 18 18 18 18 18 7 7 18 20 20 18 18 18 18 27 27 27 27 27 18 18 18 18 18 18 7 7 7
7 7 18 18 7 7 18 18 18 18 18 7 7 18 20 4 18 20 20 18 7 7 7 7 7 18 18 18 20 20 20 18 18 18
7 7 18 18 7 7 18 18 18 18 18 7 7 18 18 7 18 20 4 18 7 7 7 7 7 18 18 18 20 7 20 18 18 18
7 7 18 18 7 7 18 18 18 18 18 7 7 18 18 7 18 18 7 18 7 7 7 7 7 18 18 18 7 7 18 18 18 18
7 7 22 22 7 7 22 22 22 22 22 7 7 22 22 7 22 22 7 22 7 7 7 7 7 22 22 22 7 7 22 22 22 22