50 17
38 38 38 38 38 38 38 38 38 38 38 38 38 38 38 38 38 38 38 38 38 38 38 38 38 38 38 38 41 38 38 38 38 38 38 38 38 38 38 38 38 38 38 38 38 38 38 38 38 38
38 38 38 41 41 41 41 41 41 41 41 41 41 41 38 38 38 38 38 38 38 38 38 38 38 38 38 38 41 41 41 41 41 41 38 38 38 38 38 38 38 38 38 38 38 38 38 38 38 38
38 38 38 38 38 38 38 38 38 38 38 38 38 41 41 38 38 38 38 38 38 38 38 38 38 38 38 38 38 38 38 38 38 41 41 38 38 38 38 38 38 38 38 38 38 38 38 38 38 38
41 38 38 38 38 38 38 38 38 38 38 38 38 38 41 41 38 38 38 38 38 38 38 38 38 38 38 38 38 38 38 38 38 38 41 38 38 38 38 38 38 38 38 38 38 38 38 38 38 38
38 41 38 38 38 38 38 38 38 38 38 38 38 38 38 41 41 41 41 41 41 41 41 41 41 41 41 41 38 38 38 38 38 38 41 41 41 41 30 30 41 41 41 38 38 38 38 38 41 30
38 38 41 38 38 38 38 38 38 38 38 38 38 38 38 38 38 38 38 38 38 38 38 38 41 41 41 41 41 41 38 38 38 38 41 38 38 41 31 31 41 38 38 38 38 38 38 38 38 31
38 38 41 41 41 41 41 41 41 41 41 38 38 38 38 38 38 38 38 38 38 38 38 38 41 41 41 41 41 41 41 38 38 38 41 38 38 41 31 31 41 38 38 38 38 38 38 38 38 31
38 38 38 38 38 38 38 38 38 38 38 41 38 38 38 38 38 38 38 38 38 38 38 38 41 41 41 41 41 41 41 38 38 38 41 38 38 41 31 31 41 38 38 38 38 38 38 38 38 31
38 38 38 38 38 38 38 38 38 38 38 38 38 38 38 38 38 38 38 38 38 38 38 38 41 41 41 41 41 41 38 38 38 41 41 38 38 41 31 31 41 38 38 38 38 38 38 38 38 31
38 38 38 38 38 38 38 38 38 38 38 38 38 38 38 38 38 38 38 38 38 38 38 38 41 41 41 41 38 38 38 41 41 41 38 38 38 41 31 31 41 38 38 38 38 41 38 38 38 31
38 38 38 38 38 38 38 38 38 38 38 38 38 38 41 38 38 38 38 38 38 41 38 38 41 38 38 38 38 38 41 41 38 38 38 38 38 41 31 31 41 38 38 38 38 38 38 38 38 31
38 38 38 41 38 38 41 41 38 38 38 38 38 38 41 41 41 39 41 41 41 38 38 38 41 38 38 38 38 38 38 38 38 38 38 38 38 41 31 31 41 38 38 38 38 38 38 38 38 31
38 38 38 38 38 38 38 38 38 38 38 38 38 38 38 38 41 41 41 38 38 38 38 41 41 38 38 38 38 38 38 38 38 38 38 38 38 41 31 31 41 38 38 38 38 38 38 38 38 31
38 38 38 38 38 38 38 38 38 38 38 38 38 38 38 38 47 38 38 38 38 38 41 41 38 38 38 38 38 38 38 38 38 38 38 38 38 41 31 31 41 38 38 38 38 38 38 38 38 31
38 38 41 38 38 38 38 38 38 38 38 41 38 38 38 38 45 38 38 38 38 41 41 41 38 38 38 38 38 38 38 41 38 38 38 38 38 38 31 31 41 38 38 38 38 38 38 38 38 31
38 38 38 38 38 38 38 38 38 38 38 38 38 38 38 38 46 38 38 38 41 41 38 38 38 38 38 41 41 38 38 38 38 38 38 38 38 38 31 31 41 38 38 38 38 38 38 38 38 31
41 41 39 39 39 39 39 39 39 39 39 39 39 41 41 41 41 41 41 41 41 41 41 41 41 41 41 41 41 39 39 39 41 41 41 41 41 41 41 41 41 39 39 39 39 39 39 39 39 39