34 17
38 38 38 38 38 38 38 38 38 38 38 38 38 38 38 38 38 38 38 38 38 38 38 38 38 38 38 38 38 38 38 38 38 38
38 38 38 38 38 38 38 38 38 38 38 38 38 38 38 38 38 38 38 38 38 38 38 38 38 38 38 38 38 38 38 38 38 38
38 38 38 38 38 38 38 38 38 38 38 38 38 38 38 38 38 38 38 38 38 38 38 38 38 38 38 38 38 38 38 38 38 38
38 38 38 38 38 38 38 38 38 38 38 38 38 38 38 38 38 38 38 38 38 38 38 38 38 38 38 38 38 38 38 38 38 38
38 38 38 38 38 38 38 38 38 38 38 38 38 38 38 38 38 38 38 38 38 38 38 38 38 38 38 38 38 38 38 38 38 38
38 38 38 38 38 38 38 38 38 38 38 38 38 38 38 38 38 38 38 38 38 38 38 38 38 38 38 38 38 38 38 38 38 38
38 38 38 38 38 38 38 38 38 38 38 38 38 38 38 38 38 38 38 38 38 38 38 38 38 38 38 38 38 38 38 38 38 38
41 38 38 41 38 38 38 41 38 38 38 38 38 38 38 38 38 38 38 38 38 38 38 38 38 38 38 38 38 38 38 38 38 38
38 38 38 41 41 41 41 41 38 38 38 38 38 38 38 38 38 38 38 38 38 38 38 38 38 38 38 38 38 38 38 38 38 38
38 38 38 38 38 38 38 38 38 38 38 38 38 38 38 38 38 38 38 38 38 38 38 38 38 38 38 38 38 38 38 38 38 38
41 38 38 38 38 38 38 38 38 38 41 41 41 38 38 38 38 38 38 38 38 38 38 38 38 38 38 38 38 38 38 38 38 38
38 38 38 38 38 38 38 38 38 41 41 47 38 38 38 38 38 38 38 38 38 38 38 38 38 38 38 38 38 38 38 38 38 38
38 38 38 38 38 38 38 38 38 38 38 45 38 38 38 47 38 38 38 38 38 38 47 38 38 38 41 41 41 41 38 38 38 38
41 38 38 38 38 47 38 38 38 38 38 45 38 38 38 45 38 38 38 38 38 38 45 38 38 38 38 38 47 38 38 38 38 38
38 38 47 38 38 45 38 38 47 38 38 45 38 38 38 45 38 38 38 47 38 38 45 38 38 38 38 38 45 38 38 38 38 38
38 38 46 38 38 46 38 38 46 38 38 46 38 38 38 45 38 38 38 45 38 38 45 38 38 38 38 38 45 38 38 38 38 38
41 41 41 39 39 41 39 39 41 41 41 41 39 39 39 46 39 39 39 46 39 39 46 39 39 39 39 39 46 41 41 41 41 41