30 40
1 1 1 1 1 1 1 8 8 8 1 1 1 1 1 1 1 1 1 1 1 1 1 1 1 1 1 1 1 1
1 1 1 1 1 8 8 8 8 8 1 1 1 1 1 1 1 1 1 8 8 8 1 1 1 1 1 1 1 1
1 1 1 1 8 8 8 8 8 8 8 1 1 1 1 1 1 1 8 8 7 8 8 1 1 1 1 1 1 1
1 1 1 1 1 8 8 7 8 8 8 1 1 1 1 1 1 1 1 1 7 1 1 1 1 1 1 1 1 1
1 1 1 1 1 1 1 7 1 1 1 1 1 1 1 1 1 1 1 1 7 1 1 1 1 1 1 1 1 1
1 1 1 1 1 1 1 7 1 1 1 1 1 1 1 1 1 1 1 1 7 1 1 1 1 1 1 1 1 1
1 1 1 1 1 1 1 7 1 1 1 1 1 1 1 1 1 1 1 1 7 1 1 1 1 1 1 1 1 1
0 0 0 0 14 14 14 0 0 0 0 0 0 0 0 0 0 0 0 0 0 14 14 14 14 0 0 0 0 0
2 2 2 2 15 15 15 15 2 2 2 2 2 2 2 2 2 2 2 2 15 15 15 15 15 2 2 2 2 2
2 2 2 2 15 15 15 15 2 2 2 2 2 2 2 2 2 2 2 15 15 15 15 15 2 2 2 2 2 2
2 2 2 15 15 15 15 15 2 2 2 15 15 15 2 2 2 15 15 15 15 15 15 2 2 2 2 2 2 2
2 2 2 2 15 15 15 15 2 2 2 15 15 15 15 15 15 15 15 15 15 15 15 2 2 2 2 2 2 2
2 2 2 2 15 15 15 17 2 2 2 15 15 15 15 15 15 15 15 15 15 17 2 2 2 2 2 2 2 2
2 2 2 15 15 15 15 2 2 2 2 15 17 15 15 15 15 15 15 15 15 2 2 2 2 2 2 2 2 2
2 2 2 15 15 15 15 2 2 2 2 15 2 2 2 2 2 17 15 15 15 2 2 2 15 15 2 2 2 2
2 2 2 15 15 15 2 2 2 2 2 2 2 2 2 2 2 2 15 15 15 15 15 15 15 15 15 2 2 2
2 2 2 15 15 15 2 2 2 2 2 2 2 2 2 2 2 2 2 15 15 15 15 15 15 15 15 15 2 2
2 2 2 15 15 15 15 2 2 2 2 2 2 2 2 2 2 2 2 15 15 2 2 15 17 17 15 15 2 2
2 2 2 17 15 17 15 15 2 2 2 2 2 2 2 2 2 2 15 15 15 2 2 2 2 2 2 2 2 2
2 2 2 2 2 2 15 15 15 15 15 15 15 2 2 2 2 15 15 15 2 2 2 2 2 2 2 2 2 2
2 2 2 2 2 2 15 15 2 2 17 15 17 17 2 2 2 15 15 2 2 2 2 2 2 2 2 2 2 2
2 2 2 2 2 2 15 15 15 15 2 2 2 2 2 2 2 15 15 2 2 2 2 2 2 2 2 2 2 2
2 2 2 2 2 2 15 17 17 17 15 15 2 2 2 2 2 15 15 2 2 2 2 2 2 2 2 2 2 2
2 2 2 2 2 2 2 2 2 2 15 15 15 2 2 2 2 15 15 2 2 2 2 2 2 2 2 2 2 2
2 2 2 2 2 2 2 2 2 2 2 15 15 2 2 2 2 15 15 15 2 2 2 2 2 2 2 2 2 2
2 2 2 2 2 2 2 2 2 2 2 15 15 2 2 2 15 15 15 15 15 2 2 2 2 2 2 2 2 2
2 2 2 2 2 2 2 2 2 2 2 15 15 2 2 2 2 17 15 15 15 15 15 2 2 2 2 2 2 2
2 2 2 2 2 15 15 2 2 2 2 15 15 2 2 2 2 2 15 15 15 15 15 2 2 2 2 2 2 2
2 2 2 2 15 15 15 15 2 2 2 15 15 2 2 2 2 2 15 15 15 15 2 2 2 2 2 2 2 2
2 2 2 2 2 17 15 15 2 2 15 15 17 2 2 2 2 2 15 15 15 2 2 2 2 2 2 2 2 2
2 2 2 2 2 2 15 2 2 15 15 15 2 2 2 2 2 15 15 15 2 2 2 2 2 2 2 2 2 2
2 2 2 2 2 2 15 2 15 15 15 15 2 2 15 15 15 15 15 15 2 2 2 2 2 2 2 2 2 2
2 2 2 2 2 15 15 15 15 17 15 2 15 15 15 15 15 15 15 15 15 15 15 15 2 2 2 2 2 2
2 2 2 2 2 15 15 15 2 2 2 15 15 15 15 2 2 2 2 15 15 15 15 2 2 2 2 2 2 2
2 2 2 2 2 15 15 15 15 15 15 15 15 17 17 2 2 2 2 2 17 17 2 2 2 2 2 2 2 2
2 2 2 2 2 15 15 15 15 15 15 15 2 2 2 2 2 2 2 2 2 2 2 2 2 2 2 2 2 2
2 2 2 2 2 2 17 17 15 15 17 2 2 2 2 2 2 2 2 2 2 2 2 2 2 2 2 2 2 2
2 2 2 2 2 2 2 2 2 2 2 2 2 2 2 2 2 2 2 2 2 2 2 2 2 2 2 2 2 2
2 2 2 2 2 2 2 2 2 2 2 2 2 2 2 2 2 2 2 2 2 2 2 2 2 2 2 2 2 2
2 2 2 2 2 2 2 2 2 2 2 2 2 2 2 2 2 2 2 2 2 2 2 2 2 2 2 2 2 2