50 50
41 41 41 41 41 41 41 41 41 41 41 41 41 41 41 41 41 34 34 34 34 34 34 34 34 34 34 34 34 34 34 34 34 34 34 34 34 34 34 34 34 34 34 34 34 34 34 34 34 34
38 47 38 47 38 47 38 47 38 47 41 41 41 41 41 41 41 34 34 34 34 34 34 34 34 34 34 34 34 34 34 34 34 34 34 34 34 34 34 34 34 34 34 34 34 34 34 34 34 34
38 45 38 45 38 45 38 45 38 45 38 38 38 38 41 41 41 34 34 34 34 34 34 34 34 34 34 34 34 34 34 34 34 34 34 34 34 34 34 34 34 34 34 34 34 34 34 34 34 34
38 45 38 45 38 45 38 45 38 45 38 38 38 38 38 41 41 41 41 41 34 34 34 34 34 34 34 34 34 34 34 41 41 41 41 41 41 41 41 41 41 41 41 41 41 41 41 41 41 41
38 45 38 45 38 45 38 45 38 45 38 38 38 38 38 38 41 41 41 41 41 41 41 41 41 41 41 41 41 41 41 41 38 38 38 38 38 38 38 38 38 38 38 38 38 38 38 38 38 41
38 45 38 45 38 45 38 45 38 45 38 38 38 38 38 38 47 38 38 41 41 41 41 41 41 41 41 41 41 41 38 38 38 38 38 38 38 38 38 38 38 38 38 38 38 38 38 38 38 41
38 46 38 46 38 46 38 46 38 46 38 38 38 38 38 38 45 38 38 38 38 41 41 41 41 47 38 38 38 38 38 38 38 38 38 38 38 38 38 38 38 38 38 38 38 38 38 38 38 41
41 41 41 41 41 41 41 41 41 41 39 39 38 38 38 38 46 38 38 38 38 47 38 47 38 45 38 38 38 38 38 38 38 38 38 38 38 38 38 38 38 38 38 38 38 38 38 38 38 41
41 41 41 41 41 41 41 41 41 41 41 41 41 41 41 41 41 38 38 38 38 45 38 45 38 45 38 38 38 38 38 38 38 38 38 38 38 38 41 38 38 38 38 38 38 38 38 38 38 41
41 41 41 41 41 41 41 41 41 41 41 41 41 41 41 41 41 41 41 41 41 46 38 46 38 45 38 38 38 41 41 38 38 41 41 41 38 38 38 38 38 41 38 38 38 38 38 38 38 41
34 34 34 34 34 34 34 34 34 34 34 34 34 34 34 41 41 41 41 41 41 41 41 41 38 46 38 38 38 38 38 38 38 38 38 38 38 38 38 38 38 38 38 38 38 38 38 38 38 41
34 34 34 34 34 34 34 34 34 34 34 34 34 34 34 34 34 34 34 34 41 41 41 41 41 41 41 39 39 39 39 39 39 39 39 39 39 39 39 39 39 39 38 38 39 39 39 39 39 41
34 34 34 34 34 34 34 34 34 34 34 34 34 34 34 34 34 34 34 34 34 41 41 41 41 41 41 41 41 41 41 41 41 41 41 41 41 41 41 41 41 41 38 38 41 41 41 41 41 41
34 34 34 34 34 34 34 34 34 34 34 34 34 34 34 34 34 34 34 34 34 34 34 34 34 34 41 41 41 41 41 41 41 41 41 41 41 41 41 41 41 41 38 38 41 41 41 41 41 41
34 34 34 34 34 34 34 34 34 34 34 34 34 34 34 34 34 34 34 34 34 34 41 41 41 41 41 41 41 41 41 41 41 41 41 41 41 41 41 41 41 41 38 38 41 41 34 34 34 34
34 34 34 34 34 34 34 34 34 34 34 34 34 34 34 34 34 34 34 34 34 34 41 38 38 38 38 38 38 38 38 41 41 41 41 41 41 41 41 41 41 41 38 38 41 41 34 34 34 34
34 34 34 34 34 34 34 34 34 34 34 34 34 34 34 34 34 34 34 41 41 41 41 38 38 38 38 38 38 38 38 41 41 47 38 47 38 47 38 47 38 38 38 38 41 41 34 34 34 34
34 34 34 34 34 34 34 34 34 34 34 34 34 34 34 34 34 41 41 41 41 41 38 38 38 38 38 38 38 38 38 47 38 45 38 45 38 45 38 45 38 38 38 38 41 41 34 34 34 34
34 34 34 34 34 34 34 34 34 34 34 34 34 34 41 41 41 41 41 41 38 47 38 38 38 38 38 38 38 38 38 45 38 45 38 46 38 46 38 46 38 38 38 38 41 41 34 34 34 34
41 41 41 41 41 41 41 41 41 41 41 41 41 41 41 41 41 41 47 38 38 45 38 38 38 41 38 38 41 38 38 45 38 46 41 41 41 41 41 41 41 41 41 41 41 41 34 34 34 34
41 41 41 41 41 41 41 41 41 41 41 41 41 41 41 38 47 38 45 38 38 45 38 38 38 38 38 38 38 38 38 46 41 41 41 41 41 41 41 41 41 41 41 41 41 41 34 34 34 34
41 38 38 38 38 38 38 38 38 38 38 38 38 38 38 38 45 38 45 38 38 46 41 41 39 39 39 39 39 39 41 41 41 41 41 34 34 34 41 41 41 41 41 41 41 41 34 34 34 34
41 38 38 38 38 38 38 38 38 38 41 38 38 38 38 38 45 38 46 38 41 41 41 41 41 41 41 41 41 41 41 41 41 34 34 34 34 34 41 41 41 41 41 41 41 41 34 34 34 34
41 38 41 38 38 38 38 38 38 38 38 38 38 38 38 38 46 38 41 41 41 41 41 41 41 41 41 41 41 41 41 41 34 34 34 34 34 34 34 34 34 34 34 34 34 34 34 34 34 34
41 38 38 38 38 41 38 38 38 38 38 38 38 38 38 41 41 41 41 41 41 41 34 34 34 34 34 34 34 34 34 34 34 34 34 34 34 34 34 34 34 34 34 34 34 34 34 34 34 34
41 38 38 38 38 38 38 38 38 38 38 38 38 38 41 41 41 41 41 41 34 34 34 34 34 34 34 34 34 34 34 34 34 34 34 34 34 34 34 34 34 34 34 34 34 34 34 34 34 34
41 38 38 38 38 38 38 38 38 38 38 38 38 38 41 41 34 34 34 34 34 34 34 34 34 34 34 34 34 34 34 34 34 34 34 34 34 34 34 34 34 34 34 34 34 34 34 34 34 34
41 38 38 38 38 38 38 38 38 38 41 38 38 38 41 41 34 34 34 34 34 34 34 34 34 34 34 34 34 34 34 34 34 34 34 34 34 34 34 34 34 34 34 34 34 34 34 34 34 34
41 38 38 38 38 41 38 38 38 38 38 38 38 38 41 41 34 34 34 34 34 34 34 34 34 34 34 34 34 34 34 34 34 34 34 34 34 34 34 34 34 34 34 34 34 34 34 34 34 34
41 38 38 38 38 38 38 38 38 38 38 38 38 38 41 41 41 41 41 41 41 34 34 34 34 34 34 34 34 34 34 34 34 34 34 34 34 34 34 34 34 34 34 34 34 34 34 34 34 34
41 38 38 41 38 38 38 41 38 38 38 38 38 38 41 41 41 41 41 41 41 41 34 34 34 34 34 34 34 34 34 34 34 34 34 34 34 34 34 34 34 34 34 34 34 34 34 34 34 34
41 38 38 38 38 38 38 38 38 38 38 38 41 38 38 47 38 47 38 41 41 41 41 34 34 34 41 41 41 41 41 41 41 41 41 41 41 41 41 41 41 41 41 41 41 41 41 41 41 41
41 38 38 38 38 38 38 38 38 38 38 38 38 38 38 45 38 45 38 41 41 41 41 41 41 41 41 41 41 41 41 41 41 41 41 41 41 41 41 41 41 41 41 41 41 41 41 41 41 41
41 38 41 38 38 41 38 38 38 38 38 38 38 38 38 45 38 45 38 38 47 41 41 41 41 41 41 41 38 38 38 38 38 38 38 38 38 38 38 38 38 38 38 38 38 38 38 38 38 41
41 38 38 38 38 38 38 38 41 38 38 41 38 38 38 45 38 45 38 38 45 38 38 47 38 38 47 38 38 38 38 38 38 38 38 38 38 38 38 38 38 38 38 38 38 38 38 38 38 41
41 38 38 38 38 38 38 38 38 38 38 38 38 38 38 46 38 46 38 38 45 38 38 45 38 38 45 38 38 38 38 38 38 38 38 38 38 38 38 38 38 38 38 38 38 38 38 38 38 41
41 34 34 34 34 34 34 34 34 34 34 34 34 34 41 41 41 41 41 38 46 38 38 45 38 38 45 38 38 38 38 38 38 38 38 38 38 38 38 38 38 38 38 38 38 38 38 38 38 41
41 34 34 34 34 34 34 34 34 34 34 34 34 34 41 41 41 41 41 41 41 38 38 45 38 38 45 38 38 38 38 38 38 38 38 38 38 38 38 38 38 38 38 38 38 41 38 38 38 41
41 41 41 41 41 41 41 41 41 41 41 41 41 41 41 41 41 41 41 41 41 41 38 46 38 38 46 38 38 38 41 38 41 38 41 38 38 41 38 38 41 38 38 41 38 38 38 38 38 41
41 41 41 41 41 41 41 41 41 41 41 41 41 41 41 41 41 41 41 41 41 41 41 41 41 41 41 38 38 38 38 38 38 38 38 38 38 38 38 38 38 38 38 38 38 38 38 38 38 41
34 34 34 34 34 34 34 34 34 34 34 34 34 34 34 34 34 34 34 34 34 41 41 41 41 41 41 41 41 34 34 34 34 34 34 34 34 34 34 34 34 34 34 34 34 34 41 38 38 41
34 34 34 34 34 34 34 34 34 34 34 34 34 34 34 34 34 34 34 34 34 34 34 34 34 41 41 41 41 34 34 34 34 34 34 34 34 34 34 34 34 34 34 34 34 34 41 38 38 41
34 34 34 34 34 34 34 34 34 34 34 34 34 34 34 34 34 34 34 34 34 34 34 34 34 34 41 41 41 41 41 41 41 41 41 41 41 41 41 41 41 41 41 41 41 41 41 38 38 41
34 34 34 34 34 34 34 34 34 34 34 34 34 34 34 34 34 34 34 34 34 34 34 34 34 34 34 41 41 41 41 41 41 41 41 41 41 41 41 41 41 41 41 41 41 41 41 38 38 41
34 34 34 34 34 34 34 34 34 34 34 34 34 34 34 34 34 34 34 34 34 34 34 34 34 34 34 34 34 34 34 34 34 34 34 34 34 34 34 34 34 34 34 34 34 41 41 38 38 41
34 34 34 34 34 34 34 34 34 34 34 34 34 34 34 34 34 34 34 34 34 34 34 34 34 34 34 34 34 34 34 34 34 34 34 34 34 34 34 34 34 34 34 34 34 41 41 38 38 41
34 34 34 34 34 34 34 34 34 34 34 34 34 34 34 34 34 34 34 34 34 34 34 34 34 34 34 34 34 34 34 34 34 34 34 34 34 34 34 34 34 34 34 34 34 41 41 38 38 41
34 34 34 34 34 34 34 34 34 34 34 34 34 34 34 34 34 34 34 34 34 34 34 34 34 34 34 34 34 34 34 34 34 34 34 34 34 34 34 34 34 34 34 34 34 41 41 38 38 41
34 34 34 34 34 34 34 34 34 34 34 34 34 34 34 34 34 34 34 34 34 34 34 34 34 34 34 34 34 34 34 34 34 34 34 34 34 34 34 34 34 34 34 34 34 41 41 38 38 41
34 34 34 34 34 34 34 34 34 34 34 34 34 34 34 34 34 34 34 34 34 34 34 34 34 34 34 34 34 34 34 34 34 34 34 34 34 34 34 34 34 34 34 34 34 41 41 38 38 41