54 20
1 1 1 1 1 1 1 1 1 1 1 1 16 16 1 1 1 1 1 1 1 1 1 1 1 1 1 1 1 1 1 1 1 1 1 1 1 1 1 1 1 1 1 1 1 1 1 1 1 1 1 1 1 1
1 1 1 1 1 1 1 1 1 1 1 1 16 16 16 16 16 1 1 1 1 1 1 1 1 1 1 1 1 1 1 1 1 1 1 1 1 1 1 1 1 1 1 1 1 1 1 1 1 1 1 1 1 1
1 3 1 1 1 1 1 1 1 1 1 1 16 16 16 16 16 16 1 1 1 1 16 16 16 16 1 1 1 1 1 1 1 1 1 1 1 1 1 1 1 1 1 1 1 1 1 1 1 1 1 1 1 1
1 1 1 1 1 1 1 1 1 1 1 1 16 16 16 16 16 16 16 16 16 16 16 16 16 16 1 1 1 1 1 1 1 1 1 1 1 1 1 1 1 1 1 1 1 1 1 1 1 1 1 1 1 1
1 1 1 1 1 1 1 1 1 1 1 16 16 16 16 16 16 16 16 16 16 16 16 16 16 16 1 1 1 1 1 1 1 1 1 1 1 1 1 1 1 1 1 1 1 1 1 1 1 1 1 1 1 1
1 1 1 1 1 1 1 1 1 1 16 16 16 16 16 1 1 1 16 1 1 1 1 1 16 16 1 1 1 1 1 1 1 1 1 1 1 1 1 1 1 1 1 1 1 1 1 1 1 1 1 1 1 1
1 1 1 1 1 1 1 1 1 1 16 16 16 16 1 1 1 1 1 1 1 1 1 1 16 16 1 1 1 1 1 1 1 1 1 1 1 1 1 1 1 1 1 1 1 1 1 1 1 1 1 1 1 1
1 1 1 10 1 1 1 1 1 1 16 16 16 16 1 1 1 1 1 1 1 1 1 1 16 16 16 16 16 1 1 1 1 1 1 1 1 1 1 1 1 1 1 1 1 1 1 1 1 10 1 1 1 1
0 0 0 0 0 14 14 14 14 14 16 16 16 16 14 14 14 0 0 0 0 14 14 14 16 16 16 16 16 16 16 16 14 14 14 14 14 16 16 16 16 16 14 14 14 14 14 14 14 0 0 0 0 0
2 2 2 2 2 15 15 15 15 15 16 16 16 15 15 15 15 2 2 2 2 15 15 15 16 16 16 16 16 16 16 16 16 16 15 15 15 15 16 16 16 16 15 15 15 15 15 15 15 15 2 2 2 2
2 2 2 2 15 15 15 15 16 16 16 16 16 16 15 15 17 2 2 2 2 15 15 15 16 16 16 16 15 16 16 16 16 16 16 17 15 15 15 16 16 16 16 17 15 15 15 15 15 15 15 2 2 2
16 16 16 15 15 15 17 16 16 16 16 16 16 16 15 15 16 16 16 16 16 15 15 15 16 16 16 15 15 16 16 15 15 16 16 16 15 15 15 15 17 16 16 16 15 15 17 15 15 15 17 16 16 16
16 16 15 15 15 15 16 16 16 16 16 16 16 17 15 15 15 16 16 16 16 15 15 15 16 16 15 15 15 15 16 15 15 15 15 15 15 15 15 15 16 16 16 16 16 16 16 16 16 16 16 16 16 16
16 15 15 15 15 16 16 16 16 16 16 16 16 16 15 15 15 16 16 16 15 17 15 15 16 16 16 15 15 15 15 15 15 15 15 15 15 15 15 15 15 16 16 16 16 16 16 16 16 16 16 16 16 16
16 15 15 15 16 16 16 16 16 16 16 16 16 16 15 15 15 16 16 16 16 16 15 15 15 16 15 15 15 15 15 15 15 15 15 15 15 15 15 15 15 16 16 16 16 16 16 16 16 16 16 16 16 16
16 15 15 15 16 16 16 16 16 16 16 16 16 16 15 15 16 16 16 16 16 16 15 15 15 15 15 15 17 15 15 15 15 15 16 16 16 17 15 15 16 16 16 16 16 16 16 16 16 16 16 16 16 16
16 15 15 15 15 16 16 15 16 16 15 16 16 15 15 15 15 16 16 16 16 16 16 15 15 15 15 15 16 16 15 15 17 16 16 16 16 16 16 16 16 16 16 16 16 16 16 16 16 16 16 16 16 16
16 15 15 15 15 15 15 15 15 15 15 15 15 15 15 17 16 16 16 16 16 16 16 16 15 17 15 16 16 16 16 16 16 16 16 16 16 16 16 16 16 16 16 16 16 16 16 16 16 16 16 16 16 16
16 17 15 15 15 17 15 15 15 15 17 15 15 15 15 16 16 16 16 16 16 16 16 16 16 16 16 16 16 16 16 16 16 16 16 16 16 16 16 16 16 16 16 16 16 16 16 16 16 16 16 16 16 16
16 16 16 16 16 16 16 16 16 16 16 16 16 16 16 16 16 16 16 16 16 16 16 16 16 16 16 16 16 16 16 16 16 16 16 16 16 16 16 16 16 16 16 16 16 16 16 16 16 16 16 16 16 16