50 30
3 1 1 1 16 16 16 16 16 16 16 16 16 16 16 16 16 16 16 16 16 16 16 16 16 16 16 16 16 16 16 16 16 16 16 16 16 16 16 16 16 16 16 16 16 1 1 1 1 1
1 1 1 1 16 16 16 16 16 16 16 16 16 16 16 16 16 16 16 16 16 16 16 16 16 16 16 16 16 16 16 16 16 16 16 16 16 16 16 16 16 16 16 16 16 1 1 1 1 1
1 1 1 1 16 16 16 16 16 16 16 16 16 16 16 16 16 16 16 16 16 16 16 16 16 16 16 16 16 16 16 16 16 16 16 16 16 16 16 16 16 16 16 16 16 1 1 1 1 1
1 1 1 1 1 1 1 2 2 2 2 2 2 2 2 2 16 16 16 16 2 16 16 16 16 16 16 16 16 16 16 16 16 16 16 16 16 16 16 16 16 16 16 16 16 1 1 1 1 1
1 1 1 1 1 1 1 27 2 2 27 27 2 29 2 2 2 16 16 2 2 2 2 2 2 2 2 2 2 2 2 2 2 2 2 2 2 2 2 2 2 2 2 2 16 1 1 1 1 1
10 10 10 9 16 1 27 27 27 27 27 27 27 27 29 29 29 2 2 29 27 27 27 27 2 2 29 29 27 27 27 2 2 2 2 2 2 2 2 2 2 2 2 2 16 1 1 1 1 1
0 0 0 0 2 2 27 27 27 27 27 27 27 27 27 27 27 27 27 27 27 27 27 27 29 29 27 27 27 27 27 29 29 27 29 27 29 29 29 27 29 29 27 1 1 1 1 1 1 1
2 2 2 2 2 2 2 27 27 27 27 27 27 27 27 27 27 27 27 27 27 27 27 27 27 27 27 27 27 27 27 27 27 27 27 27 27 27 27 27 27 27 27 1 1 1 1 1 1 1
2 2 2 2 2 2 2 2 27 27 27 27 27 27 27 27 27 27 27 27 27 27 27 27 27 27 27 27 27 27 27 27 27 27 27 27 27 27 27 27 27 27 27 27 16 10 10 9 9 9
2 2 2 2 2 2 2 2 2 2 2 2 27 27 27 27 27 27 27 27 27 27 27 27 27 27 27 27 27 27 27 27 27 27 27 27 27 27 27 27 27 27 2 2 16 0 0 0 0 0
2 2 2 2 2 2 2 27 27 27 27 27 27 27 27 27 27 27 27 27 27 27 27 27 27 27 27 27 27 27 27 27 27 27 27 27 27 27 27 27 27 2 2 2 2 2 2 2 2 2
2 2 2 2 2 27 27 27 27 27 27 27 27 2 27 27 27 27 27 27 27 27 27 27 27 27 2 2 2 27 27 27 27 27 27 27 27 2 2 27 27 2 2 2 2 2 2 2 2 2
2 2 2 27 27 27 27 27 27 27 27 27 2 2 2 27 27 27 27 27 27 27 27 27 27 27 2 2 2 2 27 27 27 27 27 27 2 2 2 2 27 27 27 27 27 27 2 2 2 2
2 2 2 27 27 27 27 27 27 27 2 2 2 2 2 2 2 27 27 27 27 27 27 27 27 27 2 2 2 2 2 27 27 27 27 2 2 2 2 2 2 2 2 27 27 27 2 2 2 2
2 2 2 27 27 27 27 27 27 2 2 2 2 2 2 2 2 27 27 27 27 27 27 27 27 27 2 2 2 2 2 2 27 27 27 2 2 2 2 2 2 2 2 27 27 27 29 29 29 2
2 2 2 2 27 27 27 27 27 27 2 2 2 2 2 2 2 2 27 27 27 27 27 27 27 2 2 2 2 2 2 2 2 27 2 2 2 2 2 2 2 2 2 27 27 27 27 27 27 2
2 2 2 2 2 2 27 27 27 27 27 2 2 2 2 2 2 2 2 27 27 27 27 27 2 2 2 2 2 2 2 2 2 2 2 2 2 2 2 2 2 2 2 2 2 27 27 27 27 2
2 2 2 2 2 2 28 28 27 27 27 27 2 2 2 2 2 2 2 2 27 27 27 2 2 2 2 2 2 2 2 2 2 2 2 2 2 2 2 2 2 2 2 2 2 2 28 28 28 2
2 2 2 2 2 2 2 2 2 2 27 27 2 2 2 2 2 2 2 2 2 2 2 2 2 2 2 2 2 2 2 2 2 2 2 2 2 2 2 2 2 2 2 2 2 2 2 2 2 2
2 2 2 2 2 2 2 2 2 2 27 27 2 2 2 2 2 2 2 2 2 2 2 2 2 2 2 2 2 2 2 2 2 2 2 2 2 2 2 2 2 2 2 2 2 2 2 2 2 2
2 2 2 2 2 2 2 2 2 2 27 27 2 2 2 2 2 2 2 2 2 2 2 2 2 2 2 2 2 2 2 2 2 2 2 2 2 2 2 2 2 2 2 2 2 2 2 2 2 2
2 2 2 2 2 2 2 2 27 27 27 27 2 2 2 2 2 2 2 2 2 2 2 2 2 2 2 2 2 2 2 2 2 2 2 2 2 2 2 2 2 2 2 2 2 2 2 2 2 2
2 2 2 2 2 2 27 27 27 27 2 2 2 2 2 2 2 2 2 2 2 2 2 2 2 2 2 2 2 2 2 2 2 2 2 2 2 2 2 2 2 2 2 2 2 2 2 2 2 2
2 2 2 2 2 2 28 28 28 2 2 2 2 2 2 2 2 2 2 2 2 2 2 2 2 2 2 2 2 2 2 2 2 2 2 2 2 2 2 2 2 2 2 2 2 2 2 2 2 2
2 2 2 2 2 2 2 2 2 2 2 2 2 2 2 2 2 2 2 2 2 2 2 2 2 2 2 2 2 2 2 2 2 2 2 2 2 2 2 2 2 2 2 2 2 2 2 2 2 2
2 2 2 2 2 2 2 2 2 2 2 2 2 2 2 2 2 2 2 2 2 2 2 2 2 2 2 2 2 2 2 2 2 2 2 2 2 2 2 2 2 2 2 2 2 2 2 2 2 2
2 2 2 2 2 2 2 2 2 2 2 2 2 2 2 2 2 2 2 2 2 2 2 2 2 2 2 2 2 2 2 2 2 2 2 2 2 2 2 2 2 2 2 2 2 2 2 2 2 2
2 2 2 2 2 2 2 2 2 2 2 2 2 2 2 2 2 2 2 2 2 2 2 2 2 2 2 2 2 2 2 2 2 2 2 2 2 2 2 2 2 2 2 2 2 2 2 2 2 2
2 2 2 2 2 2 2 2 2 2 2 2 2 2 2 2 2 2 2 2 2 2 2 2 2 2 2 2 2 2 2 2 2 2 2 2 2 2 2 2 2 2 2 2 2 2 2 2 2 2
2 2 2 2 2 2 2 2 2 2 2 2 2 2 2 2 2 2 2 2 2 2 2 2 2 2 2 2 2 2 2 2 2 2 2 2 2 2 2 2 2 2 2 2 2 2 2 2 2 2